Player_Name,Team,Debute_Year,Retirment_Year,Span,Inns,HS_Not_Out,HS,NotOuts,Average,BallsFaced,StrikeRate,100s,50s,0s,Runs,debuted_year
SR Tendulkar,INDIA,1989,2012,23,452,1,200,41,44.83,21367,86.23,49,96,20,18426,1989
KC Sangakkara,SL,2000,2015,15,380,0,169,41,41.98,18048,78.86,25,93,15,14234,2000
RT Ponting,AUS,1995,2012,17,365,0,164,39,42.03,17046,80.39,30,82,20,13704,1995
ST Jayasuriya,SL,1989,2011,22,433,0,189,18,32.36,14725,91.2,28,68,34,13430,1989
DPMD Jayawardene,SL,1998,2015,17,418,0,144,39,33.37,16020,78.96,19,77,28,12650,1998
Inzamam-ul-Haq,PAK,1991,2007,16,350,1,137,53,39.52,15812,74.24,10,83,20,11739,1991
V Kohli,INDIA,2008,2019,11,233,0,183,39,59.84,12445,93.28,43,55,13,11609,2008
JH Kallis,SA,1996,2014,18,314,0,139,53,44.36,15885,72.89,17,86,17,11579,1996
SC Ganguly,INDIA,1992,2007,15,300,0,183,23,41.02,15416,73.7,22,72,16,11363,1992
R Dravid,INDIA,1996,2011,15,318,0,153,40,39.16,15284,71.24,12,83,13,10889,1996
MS Dhoni,INDIA,2004,2019,15,297,1,183,84,50.57,12303,87.56,10,73,10,10773,2004
CH Gayle,WI,1999,2019,20,294,0,215,17,37.83,12019,87.19,25,54,25,10480,1999
BC Lara,WI,1990,2007,17,289,0,169,32,40.48,13086,79.51,19,63,16,10405,1990
TM Dilshan,SL,1999,2016,17,303,1,161,41,39.27,11933,86.23,22,47,11,10290,1999
Mohammad Yousuf,PAK,1998,2010,12,273,1,141,40,41.71,12942,75.1,15,64,15,9720,1998
AC Gilchrist,AUS,1996,2008,12,279,0,172,11,35.89,9922,96.94,16,55,19,9619,1996
AB de Villiers,SA,2005,2018,13,218,0,176,39,53.5,9473,101.09,25,53,7,9577,2005
M Azharuddin,INDIA,1985,2000,15,308,1,153,54,36.92,12669,74.02,7,58,9,9378,1985
PA de Silva,SL,1984,2003,19,296,0,145,30,34.9,11443,81.13,11,64,17,9284,1984
RG Sharma,INDIA,2007,2019,12,214,0,264,32,49.14,10063,88.88,28,43,13,8944,2007
Saeed Anwar,PAK,1989,2003,14,244,0,194,19,39.21,10938,80.67,20,43,15,8824,1989
S Chanderpaul,WI,1994,2011,17,251,0,150,40,41.6,12408,70.74,11,59,6,8778,1994
Yuvraj Singh,INDIA,2000,2017,17,278,0,150,40,36.55,9924,87.67,14,52,18,8701,2000
DL Haynes,WI,1978,1994,16,237,1,152,28,41.37,13707,63.09,17,57,13,8648,1978
MS Atapattu,SL,1990,2007,17,259,1,132,32,37.57,12594,67.72,11,59,13,8529,1990
ME Waugh,AUS,1988,2002,14,236,0,173,20,39.35,11053,76.9,18,50,16,8500,1988
LRPL Taylor,NZ,2006,2019,13,212,1,181,37,47.86,10091,83.0,20,50,9,8376,2006
V Sehwag,INDIA,1999,2013,14,245,0,219,9,35.05,7929,104.33,15,38,14,8273,1999
HM Amla,SA,2008,2019,11,178,0,159,14,49.46,9178,88.39,27,39,4,8113,2008
HH Gibbs,SA,1996,2010,14,240,0,175,16,36.13,9721,83.26,21,37,22,8094,1996
Shahid Afridi,PAK,1996,2015,19,369,0,124,27,23.57,6892,117.0,6,39,30,8064,1996
SP Fleming,NZ,1994,2007,13,269,1,134,21,32.4,11242,71.49,8,49,17,8037,1994
MJ Clarke,AUS,2003,2015,12,223,0,130,44,44.58,10104,78.98,8,58,10,7981,2003
SR Waugh,AUS,1986,2002,16,288,1,120,58,32.9,9971,75.91,3,45,15,7569,1986
Shoaib Malik,PAK,1999,2019,20,258,0,143,40,34.55,9199,81.9,9,44,15,7534,1999
A Ranatunga,SL,1982,1999,17,255,1,131,47,35.84,9571,77.9,4,49,18,7456,1982
Javed Miandad,PAK,1975,1996,21,218,1,119,41,41.7,11014,67.01,8,50,8,7381,1975
EJG Morgan,ENG/IRE,2006,2019,13,217,0,148,32,39.71,8053,91.24,13,46,15,7348,2006
Younis Khan,PAK,2000,2015,15,255,0,144,23,31.24,9628,75.29,7,48,22,7249,2000
Saleem Malik,PAK,1982,1999,17,256,0,102,38,32.88,9383,76.41,5,47,19,7170,1982
NJ Astle,NZ,1995,2007,12,217,1,145,14,34.92,9760,72.64,16,41,19,7090,1995
GC Smith,SA,2002,2013,11,194,0,141,10,37.98,8648,80.81,10,47,8,6989,2002
WU Tharanga,SL,2005,2019,14,223,1,174,17,33.74,9155,75.92,15,37,17,6951,2005
MG Bevan,AUS,1994,2004,10,196,1,108,67,53.58,9320,74.16,6,46,5,6912,1994
Tamim Iqbal,BDESH,2007,2019,12,202,0,154,8,35.52,8865,77.74,11,47,18,6892,2007
G Kirsten,SA,1993,2003,10,185,1,188,19,40.95,9436,72.04,13,45,11,6798,1993
A Flower,ZIM,1992,2003,11,208,0,145,16,35.34,9097,74.59,4,55,13,6786,1992
IVA Richards,WI,1975,1991,16,167,1,189,24,47.0,7451,90.2,11,45,7,6721,1975
MJ Guptill,NZ,2009,2019,10,176,1,237,19,42.2,7586,87.34,16,35,15,6626,2009
Mohammad Hafeez,PAK,2003,2019,16,216,1,140,15,32.9,8633,76.61,11,38,19,6614,2003
GW Flower,ZIM,1992,2010,18,214,1,142,18,33.52,9723,67.58,6,40,18,6571,1992
Ijaz Ahmed,PAK,1986,2000,14,232,1,139,29,32.33,8174,80.3,10,37,14,6564,1986
AR Border,AUS,1979,1994,15,252,1,127,39,30.62,9134,71.42,3,39,11,6524,1979
Shakib Al Hasan,BDESH,2006,2019,13,194,1,134,27,37.86,7641,82.75,9,47,10,6323,2006
BRM Taylor,ZIM,2004,2019,15,192,1,145,15,35.55,8256,76.22,10,38,15,6293,2004
RB Richardson,WI,1983,1996,13,217,0,122,30,33.41,9801,63.74,5,44,8,6248,1983
ML Hayden,AUS,1993,2008,15,155,1,181,15,43.8,7767,78.96,10,36,9,6133,1993
KS Williamson,NZ,2010,2019,9,142,0,148,14,47.9,7494,81.82,13,39,5,6132,2010
Mushfiqur Rahim,BDESH,2006,2019,13,202,0,144,34,36.3,7718,79.03,7,37,10,6100,2006
BB McCullum,NZ,2002,2016,14,228,0,166,28,30.41,6312,96.37,5,32,20,6083,2002
DM Jones,AUS,1984,1994,10,161,0,145,25,44.61,8362,72.56,7,46,6,6068,1984
DC Boon,AUS,1984,1995,11,177,0,122,16,37.04,9157,65.13,5,37,6,5964,1984
JN Rhodes,SA,1992,2003,11,220,0,121,51,35.11,7336,80.9,2,33,12,5935,1992
JE Root,ENG,2013,2019,6,135,1,133,21,51.36,6702,87.37,16,33,4,5856,2013
Rameez Raja,PAK,1985,1997,12,197,1,119,15,32.09,9226,63.31,9,31,15,5841,1985
AD Mathews,SL,2008,2019,11,184,1,139,48,42.73,6974,83.33,3,40,15,5812,2008
RR Sarwan,WI,2000,2013,13,169,1,120,33,42.67,7663,75.74,5,38,8,5804,2000
CL Hooper,WI,1987,2003,16,206,1,113,43,35.34,7517,76.63,7,29,7,5761,1987
SR Watson,AUS,2002,2015,13,169,1,185,27,40.54,6365,90.44,9,33,12,5757,2002
H Masakadza,ZIM,2001,2019,18,208,1,178,4,27.73,7728,73.21,5,34,15,5658,2001
SK Raina,INDIA,2005,2018,13,194,1,116,35,35.31,6005,93.5,5,36,14,5615,2005
MN Samuels,WI,2000,2018,18,196,1,133,26,32.97,7463,75.11,10,30,11,5606,2000
WJ Cronje,SA,1992,2000,8,175,0,112,31,38.64,7277,76.47,2,39,8,5565,1992
S Dhawan,INDIA,2010,2019,9,131,0,143,7,44.5,5869,94.01,17,27,5,5518,2010
F du Plessis,SA,2011,2019,8,136,0,185,20,47.47,6215,88.6,12,35,3,5507,2011
MEK Hussey,AUS,2004,2012,8,157,1,109,44,48.15,6243,87.16,3,39,3,5442,2004
IR Bell,ENG,2004,2015,11,157,0,141,14,37.87,7019,77.16,4,35,6,5416,2004
A Jadeja,INDIA,1992,2000,8,179,0,119,36,37.47,7677,69.8,6,30,10,5359,1992
DR Martyn,AUS,1992,2006,14,182,1,144,51,40.8,6877,77.73,5,37,10,5346,1992
G Gambhir,INDIA,2003,2013,10,143,1,150,11,39.68,6144,85.25,11,34,11,5238,2003
ADR Campbell,ZIM,1992,2003,11,184,1,131,14,30.5,7834,66.18,7,30,11,5185,1992
RS Mahanama,SL,1986,1999,13,198,1,119,23,29.49,8521,60.57,4,35,15,5162,1986
CG Greenidge,WI,1975,1991,16,127,1,133,13,45.03,7908,64.92,11,31,3,5134,1975
Misbah-ul-Haq,PAK,2002,2015,13,149,1,96,31,43.4,6945,73.75,0,42,6,5122,2002
JP Duminy,SA,2004,2019,15,179,1,150,40,36.81,6052,84.55,4,27,7,5117,2004
PD Collingwood,ENG,2001,2011,10,181,1,120,37,35.36,6614,76.98,5,26,7,5092,2001
A Symonds,AUS,1998,2009,11,161,0,156,33,39.75,5504,92.44,6,30,15,5088,1998
Abdul Razzaq,PAK,1996,2011,15,228,0,112,57,29.7,6252,81.25,3,23,14,5080,1996
DA Warner,AUS,2009,2019,10,114,0,179,5,45.77,5222,95.55,17,20,2,4990,2009
CL Cairns,NZ,1991,2006,15,193,0,115,25,29.46,5874,84.26,4,26,9,4950,1991
Q de Kock,SA,2013,2019,6,115,0,178,6,45.01,5154,95.2,14,24,3,4907,2013
Aamer Sohail,PAK,1990,2000,10,155,0,134,5,31.86,7297,65.5,5,31,10,4780,1990
CD McMillan,NZ,1997,2007,10,183,0,117,16,28.18,6198,75.94,3,28,9,4707,1997
MD Crowe,NZ,1982,1995,13,140,1,107,18,38.55,6476,72.63,4,34,3,4704,1982
MV Boucher,SA,1998,2011,13,221,1,147,57,28.57,5528,84.76,1,26,16,4686,1998
AJ Stewart,ENG,1989,2003,14,162,0,116,14,31.6,6841,68.36,4,28,13,4677,1989
AJ Finch,AUS,2013,2019,6,115,1,153,2,40.34,5093,89.51,15,24,11,4559,2013
SB Styris,NZ,1999,2011,12,161,0,141,23,32.48,5645,79.41,4,28,9,4483,1999
KP Pietersen,ENG,2004,2013,9,125,0,130,16,40.73,5128,86.58,9,25,7,4440,2004
NS Sidhu,INDIA,1987,1998,11,127,1,134,8,37.08,6329,69.72,6,33,7,4413,1987
CZ Harris,NZ,1990,2004,14,213,0,130,62,29.0,6583,66.51,1,16,12,4379,1990
GR Marsh,AUS,1986,1992,6,115,1,126,6,39.97,7790,55.93,9,22,4,4357,1986
E Chigumbura,ZIM,2004,2018,14,198,0,117,26,25.23,5423,80.02,2,19,17,4340,2004
ME Trescothick,ENG,2000,2006,6,122,0,137,6,37.37,5087,85.21,12,21,13,4335,2000
GA Gooch,ENG,1976,1995,19,122,0,142,6,36.98,6932,61.88,8,23,4,4290,1976
AJ Strauss,ENG,2003,2011,8,126,0,158,8,35.63,5195,80.94,6,27,9,4205,2003
K Srikkanth,INDIA,1981,1992,11,145,0,123,4,29.01,5702,71.74,4,27,11,4091,1981
PR Stirling,IRE,2008,2019,11,111,0,177,2,37.04,4627,87.27,8,23,10,4038,2008
WTS Porterfield,IRE,2006,2019,13,133,0,139,3,31.05,5818,69.38,11,17,9,4037,2006
AJ Lamb,ENG,1982,1992,10,118,0,118,16,39.31,5308,75.54,4,26,8,4010,1982
Mahmudullah,BDESH,2007,2019,12,160,1,128,42,33.84,5222,76.48,3,21,8,3994,2007
RP Arnold,SL,1997,2007,10,155,0,103,43,35.26,5443,72.57,1,28,7,3950,1997
AP Gurusinha,SL,1985,1996,11,143,1,117,5,28.27,6409,60.88,2,22,12,3902,1985
JG Wright,NZ,1978,1992,14,148,0,101,1,26.46,6804,57.18,1,24,9,3891,1978
DJ Cullinan,SA,1993,2000,7,133,0,124,16,32.99,5492,70.28,3,23,10,3860,1993
GA Hick,ENG,1991,2001,10,118,1,126,15,37.33,5191,74.08,5,27,10,3846,1991
JC Buttler,ENG,2012,2019,7,117,0,150,23,40.88,3207,119.83,9,20,12,3843,2012
SPD Smith,AUS,2010,2019,9,104,0,164,12,41.41,4414,86.31,8,23,5,3810,2010
HP Tillakaratne,SL,1986,2003,17,168,0,104,40,29.6,6588,57.51,2,13,10,3789,1986
N Kapil Dev,INDIA,1978,1994,16,198,1,175,39,23.79,3979,95.07,1,14,13,3783,1978
Wasim Akram,PAK,1984,2003,19,280,0,86,55,16.52,4208,88.33,0,6,28,3717,1984
SC Williams,ZIM,2005,2019,14,127,1,129,18,34.1,4546,81.76,3,31,7,3717,2005
RS Kaluwitharana,SL,1990,2004,14,181,1,102,14,22.22,4776,77.7,2,23,24,3711,1990
Imran Khan,PAK,1974,1992,18,151,1,102,40,33.41,5105,72.65,1,19,6,3709,1974
PV Simmons,WI,1987,1999,12,138,0,122,11,28.93,5407,67.96,5,18,14,3675,1987
NV Knight,ENG,1996,2003,7,100,1,125,10,40.41,5085,71.52,5,25,6,3637,1996
LD Chandimal,SL,2010,2019,9,132,0,111,21,32.42,4855,74.12,4,22,11,3599,2010
L Klusener,SA,1996,2004,8,137,1,103,50,41.1,3977,89.91,2,19,13,3576,1996
SM Pollock,SA,1996,2008,12,205,0,130,72,26.45,4059,86.69,1,14,20,3519,1996
MA Taylor,AUS,1989,1997,8,110,0,105,1,32.23,5909,59.46,1,28,4,3514,1989
DB Vengsarkar,INDIA,1976,1991,15,120,0,105,19,34.73,5179,67.73,1,23,7,3508,1976
KJ O'Brien,IRE,2006,2019,13,130,0,142,17,30.88,3922,88.98,2,18,5,3490,2006
Mohammad Ashraful,BDESH,2001,2013,12,169,0,109,13,22.23,4947,70.1,3,20,14,3468,2001
SO Tikolo,KENYA,1996,2014,18,130,0,111,12,29.05,4524,75.77,3,24,13,3428,1996
HH Dippenaar,SA,1999,2007,8,95,1,125,14,42.23,5047,67.78,4,26,4,3421,1999
A Flintoff,ENG,1999,2009,10,122,0,123,16,32.01,3821,88.82,3,18,9,3394,1999
T Taibu,ZIM,2001,2012,11,137,1,107,21,29.25,5020,67.58,2,22,16,3393,2001
JJ Roy,ENG,2015,2019,4,81,0,180,2,42.79,3148,107.4,9,18,7,3381,2015
KC Wessels,AUS/SA,1983,1994,11,105,0,107,7,34.35,6088,55.3,1,26,0,3367,1983
Babar Azam,PAK,2015,2019,4,72,1,125,10,54.17,3857,87.08,11,15,2,3359,2015
AC Parore,NZ,1992,2002,10,161,0,108,32,25.68,4867,68.09,1,14,19,3314,1992
Moin Khan,PAK,1990,2004,14,183,1,72,41,23.0,4017,81.3,0,12,17,3266,1990
Kamran Akmal,PAK,2002,2017,15,138,0,124,14,26.09,3855,83.94,5,10,10,3236,2002
AN Cook,ENG,2006,2014,8,92,0,137,4,36.4,4154,77.13,5,19,7,3204,2006
HDRL Thirimanne,SL,2010,2019,9,106,1,139,14,34.71,4419,72.27,4,21,7,3194,2010
Umar Akmal,PAK,2009,2019,10,110,1,102,17,34.34,3712,86.04,2,20,8,3194,2009
DI Gower,ENG,1978,1991,13,111,0,158,8,30.77,4218,75.15,7,12,6,3170,1978
KR Rutherford,NZ,1985,1995,10,115,0,108,9,29.65,4888,64.3,2,18,6,3143,1985
BJ Haddin,AUS,2001,2015,14,115,0,110,16,31.53,3706,84.24,2,16,2,3122,2001
RJ Shastri,INDIA,1981,1992,11,128,0,109,21,29.04,5089,61.07,4,18,5,3108,1981
SM Gavaskar,INDIA,1974,1987,13,102,1,103,14,35.13,4966,62.26,1,27,8,3092,1974
DS Lehmann,AUS,1996,2005,9,101,0,119,22,38.96,3784,81.34,4,17,4,3078,1996
DA Miller,SA,2010,2019,9,110,0,139,31,38.7,3054,100.13,5,12,8,3058,2010
GJ Bailey,AUS,2012,2016,4,85,0,156,10,40.58,3645,83.51,3,22,3,3044,2012
SD Hope,WI,2016,2019,3,67,0,170,10,52.75,4046,74.32,8,15,4,3007,2016
V Sibanda,ZIM,2003,2016,13,126,0,116,4,24.54,4716,63.48,2,21,14,2994,2003
DJ Bravo,WI,2004,2014,10,141,1,112,24,25.36,3606,82.3,2,10,11,2968,2004
AM Rahane,INDIA,2011,2018,7,87,0,111,3,35.26,3767,78.63,3,24,6,2962,2011
HH Streak,ZIM,1993,2005,12,159,1,79,55,28.29,4008,73.42,0,13,6,2943,1993
WW Hinds,WI,1999,2010,11,111,1,127,10,28.51,4393,65.55,5,14,8,2880,1999
GJ Maxwell,AUS,2012,2019,7,100,0,102,11,32.32,2332,123.37,1,19,9,2877,2012
JM Bairstow,ENG,2011,2019,8,68,1,141,8,47.68,2749,104.07,9,11,5,2861,2011
DM Bravo,WI,2009,2019,10,105,0,124,13,30.85,4045,70.18,3,18,8,2839,2009
IJL Trott,ENG,2009,2013,4,65,0,137,10,51.25,3658,77.06,4,22,5,2819,2009
AL Logie,WI,1981,1993,12,133,1,109,36,28.95,3801,73.9,1,14,13,2809,1981
AH Jones,NZ,1987,1995,8,87,0,93,9,35.69,4811,57.86,0,25,4,2784,1987
Mohammad Nabi,AFG,2009,2019,10,112,0,116,12,27.82,3252,85.54,1,15,6,2782,2009
SE Marsh,AUS,2008,2019,11,72,0,151,4,40.77,3406,81.41,7,15,3,2773,2008
M Kaif,INDIA,2002,2006,4,110,1,111,24,32.01,3822,72.03,2,17,8,2753,2002
SV Carlisle,ZIM,1995,2005,10,107,1,121,8,27.67,4325,63.35,3,9,11,2740,1995
MDKJ Perera,SL,2013,2019,6,93,0,135,5,31.12,2945,93.0,5,14,8,2739,2013
Mohammad Shahzad,AFG,2009,2019,10,84,1,131,3,33.66,3082,88.48,6,14,4,2727,2009
Salman Butt,PAK,2004,2010,6,78,0,136,4,36.82,3572,76.28,8,14,15,2725,2004
RG Twose,NZ,1995,2001,6,81,0,103,11,38.81,3603,75.4,1,20,5,2717,1995
GJ Whittall,ZIM,1993,2003,10,142,0,83,22,22.54,4011,67.43,0,11,12,2705,1993
RS Bopara,ENG,2007,2015,8,109,1,101,21,30.62,3462,77.84,1,14,4,2695,2007
BA Stokes,ENG,2011,2019,8,81,1,102,15,40.63,2855,93.94,3,20,5,2682,2011
Sikandar Raza,ZIM,2013,2019,6,93,0,141,15,34.05,3249,81.74,3,14,1,2656,2013
Mudassar Nazar,PAK,1977,1989,12,115,0,95,10,25.26,5130,51.71,0,16,6,2653,1977
EC Joyce,ENG/IRE,2006,2018,12,77,1,160,8,38.0,3630,72.23,6,15,5,2622,2006
Ahmed Shehzad,PAK,2009,2017,8,81,0,124,1,32.56,3614,72.08,6,14,7,2605,2009
NJ O'Brien,IRE,2006,2018,12,101,0,109,9,28.05,3638,70.94,1,18,3,2581,2006
Zaheer Abbas,PAK,1974,1985,11,60,0,123,6,47.62,3033,84.8,7,13,2,2572,1974
CR Ervine,ZIM,2010,2019,9,90,1,130,11,32.54,3406,75.48,3,15,7,2571,2010
AC Hudson,SA,1991,1997,6,88,0,161,1,29.41,3960,64.62,2,18,6,2559,1991
TWM Latham,NZ,2012,2019,7,88,0,137,9,32.27,3096,82.36,4,15,7,2550,2012
VG Kambli,INDIA,1991,2000,9,97,0,106,21,32.59,3443,71.94,2,14,4,2477,1991
Imrul Kayes,BDESH,2008,2018,10,78,0,144,2,32.02,3423,71.1,4,16,2,2434,2008
JDP Oram,NZ,2001,2012,11,116,1,101,15,24.09,2810,86.61,1,13,8,2434,2001
TM Odoyo,KENYA,1996,2014,18,119,1,111,16,23.49,3438,70.38,1,8,13,2420,1996
AD Hales,ENG,2014,2019,5,67,0,171,3,37.79,2527,95.72,6,14,5,2419,2014
RA Smith,ENG,1988,1996,8,70,1,167,8,39.01,3473,69.65,4,15,4,2419,1988
L Vincent,NZ,2001,2007,6,99,0,172,10,27.11,3453,69.88,3,11,8,2413,2001
KJ Coetzer,SCOT,2008,2019,11,57,0,156,2,43.8,2795,86.18,4,17,5,2409,2008
KA Pollard,WI,2007,2019,12,99,0,119,7,26.06,2547,94.14,3,10,13,2398,2007
CJ Chibhabha,ZIM,2005,2018,13,103,0,99,2,23.65,3784,63.13,0,16,7,2389,2005
GP Thorpe,ENG,1993,2002,9,77,0,89,13,37.18,3344,71.17,0,21,3,2380,1993
Rahmat Shah,AFG,2013,2019,6,69,0,114,2,35.2,3366,70.08,4,16,3,2359,2013
Asghar Afghan,AFG,2009,2019,10,105,0,101,9,24.54,3531,66.72,1,12,7,2356,2009
VVS Laxman,INDIA,1998,2006,8,83,0,131,7,30.76,3282,71.23,6,10,3,2338,1998
RR Singh,INDIA,1989,2001,12,113,0,100,23,25.95,3144,74.3,1,9,5,2336,1989
N Hussain,ENG,1989,2003,14,87,0,115,10,30.28,3481,66.99,1,16,6,2332,1989
GS Chappell,AUS,1971,1983,12,72,1,138,14,40.18,3079,75.7,3,14,7,2331,1971
Sarfaraz Ahmed,PAK,2007,2019,12,90,0,105,22,33.85,2622,87.79,2,11,1,2302,2007
SL Campbell,WI,1994,2001,7,87,0,105,0,26.24,3853,59.25,2,14,9,2283,1994
DL Vettori,NZ,1997,2015,18,187,0,83,57,17.33,2715,82.98,0,4,23,2253,1997
S Matsikenyeri,ZIM,2002,2015,13,110,0,90,9,22.01,3072,72.39,0,13,8,2224,2002
GM Wood,AUS,1978,1989,11,77,1,114,11,33.62,3725,59.57,3,11,4,2219,1978
NLTC Perera,SL,2009,2019,10,128,0,140,16,19.73,1979,111.67,1,10,11,2210,2009
MJ Greatbatch,NZ,1988,1996,8,83,0,111,5,28.28,3099,71.18,2,13,7,2206,1988
JC Adams,WI,1992,2001,9,105,0,82,28,28.62,3614,60.98,0,14,7,2204,1992
Shahriar Nafees,BDESH,2005,2011,6,75,1,123,5,31.44,3167,69.49,4,13,11,2201,2005
D Ramdin,WI,2005,2016,11,110,0,169,22,25.0,2738,80.35,2,8,4,2200,2005
RA Jadeja,INDIA,2009,2019,10,106,0,87,36,31.25,2543,86.04,0,11,6,2188,2009
CS MacLeod,SCOT,2008,2019,11,64,0,175,6,37.5,2623,82.92,8,8,8,2175,2008
Habibul Bashar,BDESH,1995,2007,12,105,0,78,5,21.68,3586,60.45,0,14,18,2168,1995
IT Botham,ENG,1976,1992,16,106,0,79,15,23.21,2671,79.1,0,9,6,2113,1976
MW Gatting,ENG,1977,1993,16,88,1,115,17,29.5,2968,70.58,1,9,4,2095,1977
NH Fairbrother,ENG,1987,1999,12,71,0,113,18,39.47,2903,72.06,1,16,2,2092,1987
RL Powell,WI,1999,2005,6,100,0,124,16,24.82,2157,96.66,1,8,8,2085,1999
CL White,AUS,2005,2018,13,77,0,105,16,33.96,2586,80.12,2,11,4,2072,2005
GC Wilson,IRE,2007,2019,12,99,0,113,12,23.81,2880,71.94,1,12,6,2072,2007
CO Obuya,KENYA,2001,2014,13,89,1,98,9,25.55,2981,68.56,0,11,6,2044,2001
Yasir Hameed,PAK,2003,2007,4,56,1,127,1,36.87,3029,66.95,3,12,2,2028,2003
WPUJC Vaas,SL,1994,2008,14,220,1,50,72,13.68,2796,72.42,0,1,25,2025,1994
KO Otieno,KENYA,1996,2009,13,87,0,144,1,23.44,3561,56.61,2,12,12,2016,1996
SV Manjrekar,INDIA,1988,1996,8,70,0,105,10,33.23,3101,64.3,1,15,3,1994,1988
MP Vaughan,ENG,2001,2007,6,83,1,90,10,27.15,2898,68.39,0,16,9,1982,2001
CH Lloyd,WI,1973,1985,12,69,0,102,19,39.54,2434,81.22,1,11,1,1977,1973
GD Elliott,NZ,2008,2016,8,69,0,115,11,34.06,2416,81.78,2,11,6,1976,2008
BKG Mendis,SL,2016,2019,3,71,0,102,3,29.01,2367,83.35,1,16,10,1973,2016
KJ Hughes,AUS,1977,1985,8,88,0,98,6,24.0,2919,67.42,0,17,12,1968,1977
A Bagai,CAN,2003,2013,10,60,1,137,8,37.76,2995,65.57,2,16,2,1964,2003
Fakhar Zaman,PAK,2017,2019,2,46,1,210,4,46.61,2056,95.23,4,13,5,1958,2017
LMP Simmons,WI,2006,2015,9,65,0,122,3,31.58,2680,73.05,2,16,9,1958,2006
Aftab Ahmed,BDESH,2004,2010,6,85,0,92,6,24.73,2353,83.04,0,14,8,1954,2004
PJL Dujon,WI,1981,1991,10,120,1,82,36,23.15,2881,67.51,0,6,8,1945,1981
M Amarnath,INDIA,1975,1989,14,75,1,102,12,30.53,3334,57.7,2,13,2,1924,1975
KLT Arthurton,WI,1988,1999,11,93,0,84,20,26.08,2822,67.46,0,9,12,1904,1988
Imran Nazir,PAK,1999,2009,10,79,0,160,2,24.61,2339,81.01,2,9,10,1895,1999
RD Berrington,SCOT,2008,2019,11,73,1,101,6,28.08,2535,74.24,1,13,3,1882,2008
Mohsin Khan,PAK,1977,1986,9,75,1,117,5,26.81,3373,55.64,2,8,3,1877,1977
JV Coney,NZ,1979,1987,8,80,1,66,19,30.72,2885,64.95,0,8,1,1874,1979
DJG Sammy,WI,2004,2015,11,105,0,89,30,24.94,1870,100.05,0,9,4,1871,2004
RD Jacobs,WI,1996,2004,8,112,1,80,32,23.31,2662,70.06,0,9,11,1865,1996
M Prabhakar,INDIA,1984,1996,12,98,0,106,21,24.12,3083,60.26,2,11,8,1858,1984
Azhar Ali,PAK,2011,2018,7,53,0,102,3,36.9,2478,74.45,3,12,3,1845,2011
OA Shah,ENG,2001,2009,8,66,1,107,6,30.56,2331,78.67,1,12,6,1834,2001
MW Goodwin,ZIM,1998,2000,2,70,1,112,3,27.13,2654,68.5,2,8,1,1818,1998
Khaled Mashud,BDESH,1995,2006,11,110,1,71,27,21.9,3315,54.84,0,7,8,1818,1995
BA Edgar,NZ,1978,1986,8,64,1,102,5,30.74,3685,49.22,1,10,3,1814,1978
A Balbirnie,IRE,2010,2019,9,61,1,145,4,31.8,2413,75.13,5,8,4,1813,2010
Samiullah Shinwari,AFG,2009,2019,10,74,0,96,12,29.2,2765,65.49,0,11,1,1811,2009
JO Holder,WI,2013,2019,6,89,1,99,19,25.68,1907,94.28,0,9,9,1798,2013
DJ Hussey,AUS,2008,2013,5,61,0,111,6,32.65,1980,90.7,1,14,4,1796,2008
MA Atherton,ENG,1990,1998,8,54,0,127,3,35.11,3054,58.64,2,12,4,1791,1990
Mashrafe Mortaza,BDESH,2001,2019,18,156,1,51,27,13.84,2037,87.67,0,1,15,1786,2001
MS Wade,AUS,2012,2017,5,80,1,100,11,25.75,2164,82.11,1,10,5,1777,2012
MM Ali,ENG,2014,2019,5,82,0,128,13,25.59,1697,104.06,3,5,5,1766,2014
IA Healy,AUS,1988,1997,9,120,0,56,36,21.0,2104,83.84,0,4,9,1764,1988
KD Karthik,INDIA,2004,2019,15,79,0,79,21,30.2,2392,73.24,0,9,6,1752,2004
Sir RJ Hadlee,NZ,1973,1990,17,98,0,79,17,21.61,2319,75.5,0,4,4,1751,1973
Soumya Sarkar,BDESH,2014,2019,5,54,1,127,3,33.88,1753,98.57,2,11,5,1728,2014
Imam-ul-Haq,PAK,2017,2019,2,37,0,151,5,53.84,2141,80.47,7,6,2,1723,2017
Imran Farhat,PAK,2001,2013,12,58,0,107,2,30.69,2489,69.06,1,13,3,1719,2001
CB Wishart,ZIM,1996,2005,9,82,1,172,8,23.22,2436,70.56,2,5,8,1719,1996
Rashid Latif,PAK,1992,2003,11,117,0,79,29,19.42,2237,76.39,0,3,8,1709,1992
DA Gunawardene,SL,1998,2006,8,61,0,132,1,28.46,2389,71.49,1,12,5,1708,1998
AT Rayudu,INDIA,2013,2019,6,50,1,124,14,47.05,2143,79.04,3,10,3,1694,2013
ND McKenzie,SA,2000,2009,9,55,1,131,10,37.51,2432,69.4,2,10,2,1688,2000
NC Johnson,ZIM,1998,2000,2,48,1,132,2,36.5,2389,70.28,4,11,2,1679,1998
BA Young,NZ,1990,1999,9,73,0,74,5,24.52,2733,61.03,0,9,5,1668,1990
UDU Chandana,SL,1994,2007,13,111,0,89,17,17.3,2229,72.99,0,5,8,1627,1994
CK Kapugedera,SL,2006,2017,11,84,0,95,7,21.09,2254,72.04,0,8,7,1624,2006
Haris Sohail,PAK,2013,2019,6,40,0,130,5,46.11,1895,85.17,2,13,1,1614,2013
GM Turner,NZ,1973,1983,10,40,1,171,6,47.0,2348,68.05,3,9,1,1598,1973
LPC Silva,SL,1999,2011,12,62,1,107,7,28.85,2254,70.4,1,13,6,1587,1999
Najibullah Zadran,AFG,2012,2019,7,62,1,104,9,29.92,1765,89.85,1,11,3,1586,2012
SC Williams,WI,1994,1999,5,55,1,105,6,32.36,2402,66.02,1,12,6,1586,1994
Saleem Elahi,PAK,1995,2004,9,47,0,135,4,36.72,2214,71.31,4,9,3,1579,1995
RL Dias,SL,1979,1987,8,55,0,121,5,31.46,2315,67.94,2,11,3,1573,1979
N Dickwella,SL,2014,2019,5,49,0,116,1,32.72,1679,93.56,2,9,1,1571,2014
DR Smith,WI,2004,2015,11,89,0,97,5,18.57,1683,92.69,0,8,14,1560,2004
UT Khawaja,AUS,2013,2019,6,39,0,104,2,42.0,1848,84.09,2,12,2,1554,2013
IK Pathan,INDIA,2004,2012,8,87,0,83,21,23.39,1941,79.54,0,5,7,1544,2004
RN ten Doeschate,NL,2006,2011,5,32,0,119,9,67.0,1757,87.7,5,9,1,1541,2006
DL Houghton,ZIM,1983,1997,14,60,0,142,2,26.37,2155,70.99,1,12,5,1530,1983
LRD Mendis,SL,1975,1989,14,74,0,80,9,23.49,2034,75.07,0,7,4,1527,1975
Azhar Mahmood,PAK,1996,2007,11,110,0,67,26,18.1,1988,76.5,0,3,9,1521,1996
RS Morton,WI,2002,2010,8,51,1,110,6,33.75,2289,66.36,2,10,7,1519,2002
JJ Crowe,NZ,1983,1990,7,71,1,88,12,25.72,2456,61.8,0,7,6,1518,1983
JM Kemp,SA,2001,2007,6,66,1,100,18,31.5,1819,83.12,1,10,6,1512,2001
RD Shah,KENYA,1998,2007,9,55,0,113,1,27.88,2298,65.53,1,12,5,1506,1998
MA Ouma,KENYA,2004,2014,10,77,0,61,5,20.84,2525,59.44,0,7,6,1501,2004
HJH Marshall,NZ,2003,2007,4,62,1,101,9,27.43,1990,73.06,1,12,3,1454,2003
DD Ebrahim,ZIM,2001,2005,4,76,0,121,6,20.61,2540,56.81,1,4,8,1443,2001
MR Marsh,AUS,2011,2018,7,49,1,102,9,35.7,1534,93.08,1,11,4,1428,2011
Nasir Jamshed,PAK,2008,2015,7,48,0,112,3,31.51,1881,75.38,3,8,5,1418,2008
SO Hetmyer,WI,2017,2019,2,40,0,139,3,38.27,1323,107.02,5,4,2,1416,2017
HA Gomes,WI,1978,1987,9,64,0,101,15,28.87,2578,54.88,1,6,5,1415,1978
N Boje,SA,1995,2005,10,71,0,129,18,26.67,1594,88.7,2,4,2,1414,1995
MO Odumbe,KENYA,1996,2003,7,59,0,83,5,26.09,2014,69.96,0,11,6,1409,1996
P Utseya,ZIM,2004,2015,11,132,1,68,48,16.73,2410,58.34,0,4,16,1406,2004
E Lewis,WI,2016,2019,3,45,1,176,2,32.6,1704,82.27,2,7,2,1402,2016
L Ronchi,AUS/NZ,2008,2017,9,68,1,170,9,23.67,1220,114.5,1,4,7,1397,2008
GP Howarth,NZ,1975,1985,10,65,0,76,5,23.06,2301,60.14,0,6,1,1384,1975
JD Ryder,NZ,2008,2014,6,42,0,107,1,33.21,1429,95.31,3,6,5,1362,2008
BC Broad,ENG,1987,1988,1,34,0,106,0,40.02,2447,55.61,1,11,2,1361,1987
DO Obuya,KENYA,2001,2012,11,73,0,93,3,19.35,2135,63.46,0,6,10,1355,2001
KM Jadhav,INDIA,2014,2019,5,50,0,120,18,42.31,1325,102.18,2,6,2,1354,2014
Asad Shafiq,PAK,2010,2017,7,58,0,84,4,24.74,1979,67.5,0,9,5,1336,2010
PG Fulton,NZ,2004,2009,5,46,0,112,5,32.53,1833,72.77,1,8,2,1334,2004
Sabbir Rahman,BDESH,2014,2019,5,59,0,102,7,25.63,1461,91.23,1,6,5,1333,2014
KMDN Kulasekara,SL,2003,2017,14,123,0,73,37,15.43,1629,81.46,0,4,13,1327,2003
JR Hopes,AUS,2005,2010,5,61,1,63,8,25.01,1415,93.71,0,3,1,1326,2005
SM Katich,AUS,2001,2006,5,42,1,107,5,35.78,1926,68.74,1,9,3,1324,2001
Javed Omar,BDESH,1995,2007,12,59,1,85,4,23.85,2528,51.89,0,10,2,1312,1995
Raqibul Hasan,BDESH,2008,2011,3,54,0,89,7,27.82,2133,61.32,0,8,6,1308,2008
AA Obanda,KENYA,2007,2014,7,45,1,96,2,30.37,1764,74.03,0,9,2,1306,2007
MS Sinclair,NZ,2000,2009,9,50,1,118,4,28.34,2086,62.51,2,8,8,1304,2000
PN Kirsten,SA,1991,1994,3,40,0,97,6,38.02,2308,56.02,0,9,0,1293,1991
J Charles,WI,2012,2016,4,48,0,130,0,26.72,1531,83.8,2,4,7,1283,2012
MJ Prior,ENG,2004,2011,7,62,0,87,9,24.18,1670,76.76,0,3,5,1282,2004
Nasir Hossain,BDESH,2011,2018,7,52,0,100,8,29.11,1605,79.81,1,6,4,1281,2011
TM Head,AUS,2016,2018,2,39,0,128,2,34.4,1414,90.02,1,10,1,1273,2016
NR Mongia,INDIA,1994,2000,6,96,0,69,33,20.19,1846,68.9,0,2,4,1272,1994
C Munro,NZ,2013,2019,6,53,0,87,2,24.92,1214,104.69,0,8,7,1271,2013
JEC Franklin,NZ,2001,2013,12,80,1,98,27,23.96,1651,76.92,0,4,5,1270,2001
AB Agarkar,INDIA,1998,2007,9,113,0,95,26,14.58,1574,80.62,0,3,10,1269,1998
Shoaib Mohammad,PAK,1984,1993,9,58,1,126,6,24.4,2492,50.92,1,8,8,1269,1984
Basit Ali,PAK,1993,1996,3,43,1,127,6,34.18,1669,75.79,1,9,3,1265,1993
MN Waller,ZIM,2009,2018,9,72,1,99,6,19.07,1639,76.81,0,5,10,1259,2009
MD Gunathilaka,SL,2015,2019,4,37,0,133,1,34.69,1454,85.9,2,8,1,1249,2015
JDS Neesham,NZ,2013,2019,6,50,1,97,10,31.17,1260,98.96,0,6,2,1247,2013
SP O'Donnell,AUS,1985,1991,6,64,1,74,15,25.34,1534,80.96,0,9,5,1242,1985
RR Rossouw,SA,2014,2016,2,35,0,132,3,38.71,1313,94.36,3,7,5,1239,2014
Harbhajan Singh,INDIA,1998,2015,17,128,0,49,35,13.3,1526,81.06,0,0,17,1237,1998
SG Law,AUS,1994,1999,5,51,0,110,5,26.89,1643,75.28,1,7,3,1237,1994
Alok Kapali,BDESH,2002,2011,9,66,0,115,3,19.6,1817,67.96,1,5,5,1235,2002
GM Hamilton,SCOT,1999,2010,11,38,0,119,3,35.17,1847,66.64,2,7,1,1231,1999
D Mongia,INDIA,2001,2007,6,51,1,159,7,27.95,1721,71.47,1,4,4,1230,2001
RW Marsh,AUS,1971,1984,13,76,0,66,15,20.08,1489,82.26,0,4,7,1225,1971
HDPK Dharmasena,SL,1994,2004,10,87,1,69,33,22.62,1879,65.03,0,4,2,1222,1994
Shaiman Anwar,UAE,2014,2019,5,40,0,106,1,31.25,1477,82.53,1,11,2,1219,2014
Noor Ali Zadran,AFG,2009,2019,10,50,0,114,1,24.81,1923,63.23,1,7,4,1216,2009
TM Moody,AUS,1987,1999,12,64,0,89,12,23.28,1747,69.31,0,10,6,1211,1987
Junaid Siddique,BDESH,2007,2011,4,53,0,100,1,23.0,1753,68.22,1,6,6,1196,2007
Mohammad Rafique,BDESH,1995,2007,12,106,0,77,17,13.38,1663,71.61,0,2,15,1191,1995
CR Woakes,ENG,2011,2019,8,68,1,95,20,24.7,1316,90.12,0,4,6,1186,2011
B Lee,AUS,2000,2012,12,110,0,59,44,17.81,1407,83.58,0,3,16,1176,2000
JA Rudolph,SA,2003,2006,3,39,0,81,6,35.57,1725,68.05,0,7,0,1174,2003
Nawroz Mangal,AFG,2009,2016,7,48,0,129,6,27.11,1512,75.33,2,4,4,1139,2009
MH Cross,SCOT,2014,2019,5,48,0,114,1,24.17,1536,73.95,2,5,0,1136,2014
T Mishra,KENYA,2006,2013,7,40,0,72,7,34.18,1534,73.53,0,8,4,1128,2006
HM Nicholls,NZ,2015,2019,4,43,1,124,10,33.93,1359,82.41,1,9,5,1120,2015
PL Mommsen,SCOT,2010,2017,7,42,1,139,6,30.97,1615,69.04,2,6,2,1115,2010
MF Maharoof,SL,2004,2016,12,75,1,69,18,19.52,1294,86.01,0,2,3,1113,2004
CJ Anderson,NZ,2013,2017,4,45,1,131,5,27.72,1020,108.72,1,4,4,1109,2013
HS Modi,KENYA,1996,2006,10,56,1,78,9,23.59,1906,58.18,0,5,5,1109,1996
ES Szwarczynski,NL,2006,2014,8,40,0,98,3,29.78,1615,68.23,0,10,2,1102,2006
VS Solanki,ENG,2000,2006,6,46,0,106,5,26.75,1504,72.93,2,5,2,1097,2000
B Zuiderent,NL,1996,2011,15,56,1,77,10,23.84,1873,58.56,0,8,7,1097,1996
PA Strang,ZIM,1994,2001,7,73,0,47,24,22.24,1651,66.02,0,0,5,1090,1994
G Boycott,ENG,1971,1981,10,34,0,105,4,36.06,2020,53.56,1,9,1,1082,1971
F Behardien,SA,2013,2018,5,49,0,70,14,30.68,1097,97.9,0,6,4,1074,2013
NL McCullum,NZ,2009,2015,6,62,0,65,11,20.98,1220,87.7,0,4,3,1070,2009
Asif Mujtaba,PAK,1986,1996,10,55,1,113,14,26.04,1671,63.91,1,6,8,1068,1986
DW Randall,ENG,1976,1985,9,45,0,88,5,26.67,1702,62.69,0,5,4,1067,1976
Hashmatullah Shahidi,AFG,2013,2019,6,39,1,97,6,32.18,1667,63.7,0,9,4,1062,2013
DS Smith,WI,2003,2013,10,45,0,107,2,24.62,1506,70.31,1,5,4,1059,2003
JK Kamande,KENYA,1999,2011,12,72,0,74,11,17.29,1685,62.61,0,3,8,1055,1999
IDS Smith,NZ,1980,1992,12,77,1,62,16,17.29,1061,99.43,0,3,7,1055,1980
C Kieswetter,ENG,2010,2013,3,40,0,107,5,30.11,1172,89.93,1,5,4,1054,2010
Anamul Haque,BDESH,2012,2019,7,35,0,120,0,30.05,1488,70.69,3,3,6,1052,2012
MP Stoinis,AUS,2015,2019,4,38,1,146,7,33.87,1143,91.86,1,6,3,1050,2015
KD Mills,NZ,2001,2015,14,101,0,54,34,15.62,1282,81.66,0,2,8,1047,2001
JM How,NZ,2005,2011,6,37,0,139,1,29.05,1572,66.53,1,7,3,1046,2005
Gulbadin Naib,AFG,2011,2019,8,56,1,82,8,21.68,1424,73.1,0,5,5,1041,2011
AD Russell,WI,2011,2019,8,47,1,92,9,27.21,794,130.22,0,4,6,1034,2011
JP Faulkner,AUS,2013,2017,4,52,0,116,22,34.4,990,104.24,1,4,4,1032,2013
DSBP Kuruppu,SL,1983,1990,7,52,0,72,1,20.03,1978,51.66,0,4,3,1022,1983
AG Prince,SA,2002,2007,5,41,1,89,12,35.1,1502,67.77,0,3,4,1018,2002
SK Warne,AUS,1993,2005,12,107,0,55,29,13.05,1413,72.04,0,1,10,1018,1993
SM Patil,INDIA,1980,1986,6,42,0,84,1,24.51,1223,82.17,0,9,4,1005,1980
KOA Powell,WI,2009,2018,9,44,0,83,0,22.84,1278,78.63,0,9,4,1005,2009
Rajin Saleh,BDESH,2003,2006,3,43,1,108,1,23.92,1833,54.82,1,6,5,1005,2003
PW Borren,NL,2006,2014,8,50,0,96,5,22.31,1176,85.37,0,5,5,1004,2006
NFI McCallum,SCOT,2006,2011,5,42,1,121,6,27.83,1451,69.05,2,4,3,1002,2006
Khaled Mahmud,BDESH,1998,2006,8,72,0,50,3,14.36,1461,67.83,0,1,9,991,1998
BL Cairns,NZ,1974,1985,11,65,0,60,6,16.72,941,104.88,0,2,6,987,1974
MJ Slater,AUS,1993,1997,4,42,0,73,1,24.07,1634,60.4,0,9,3,987,1993
MJ Horne,NZ,1997,2002,5,48,0,74,0,20.41,1515,64.68,0,5,3,980,1997
Akram Khan,BDESH,1988,2003,15,44,0,65,2,23.23,1721,56.71,0,5,3,976,1988
TLW Cooper,NL,2010,2013,3,22,0,101,2,48.8,1391,70.16,1,8,0,976,2010
Javed Ahmadi,AFG,2010,2019,9,41,0,81,0,23.8,1291,75.6,0,7,2,976,2010
Naeem Islam,BDESH,2008,2014,6,51,0,84,15,27.08,1473,66.19,0,5,5,975,2008
DF Watts,SCOT,2006,2011,5,35,0,101,1,28.64,1559,62.47,1,9,4,974,2006
Waqar Younis,PAK,1989,2003,14,139,0,37,45,10.3,1445,67.05,0,0,15,969,1989
Fawad Alam,PAK,2007,2015,8,36,1,114,12,40.25,1297,74.47,1,6,3,966,2007
SA Thomson,NZ,1990,1996,6,52,0,83,10,22.95,1427,67.55,0,5,2,964,1990
JF Mooney,IRE,2006,2015,9,55,0,96,14,23.48,1215,79.25,0,3,6,963,2006
GM Ritchie,AUS,1982,1987,5,42,0,84,7,27.4,1479,64.84,0,6,2,959,1982
HH Pandya,INDIA,2016,2019,3,38,0,83,6,29.9,828,115.57,0,4,3,957,2016
RR Watson,SCOT,2006,2010,4,35,1,123,4,30.83,1286,74.33,1,6,4,956,2006
MD Marshall,WI,1980,1992,12,83,0,66,19,14.92,1246,76.64,0,2,5,955,1980
SF Mire,ZIM,2014,2019,5,47,0,112,0,20.31,1190,80.25,1,3,4,955,2014
Imad Wasim,PAK,2015,2019,4,39,1,63,16,41.39,868,109.67,0,5,1,952,2015
MG Johnson,AUS,2005,2015,10,91,1,73,32,16.11,987,96.35,0,2,6,951,2005
RS Madugalle,SL,1979,1988,9,56,0,73,5,18.62,1574,60.35,0,3,4,950,1979
NT Broom,NZ,2009,2017,8,39,1,109,4,26.94,1161,81.22,1,5,7,943,2009
A Kumble,INDIA,1990,2007,17,136,0,26,47,10.53,1536,61.06,0,0,18,938,1990
CM Spearman,NZ,1995,2001,6,50,0,86,0,18.72,1202,77.87,0,5,6,936,1995
RV Uthappa,INDIA,2006,2015,9,42,0,86,6,25.94,1031,90.59,0,6,4,934,2006
W Barresi,NL,2010,2019,9,31,1,137,5,35.65,1225,75.67,1,6,4,927,2010
AN Kervezee,NL,2006,2012,6,36,0,92,3,28.0,1263,73.15,0,4,2,924,2006
S Dhaniram,CAN,2006,2010,4,41,0,92,4,24.72,1126,81.26,0,6,2,915,2006
AJ Hall,SA,1999,2007,8,56,0,81,13,21.04,1206,75.04,0,3,5,905,1999
Rashid Khan,AFG,2015,2019,4,56,1,60,9,19.25,906,99.88,0,4,6,905,2015
MJ Santner,NZ,2015,2019,4,54,0,67,21,27.21,1021,87.95,0,2,3,898,2015
TD Paine,AUS,2009,2018,9,35,0,111,3,27.81,1257,70.8,1,5,1,890,2009
KL Rahul,INDIA,2016,2019,3,25,0,111,4,42.33,1098,80.96,3,5,2,889,2016
JWA Taylor,ENG,2011,2015,4,26,0,101,5,42.23,1107,80.12,1,7,2,887,2011
J Srinath,INDIA,1991,2003,12,121,0,53,38,10.63,1109,79.62,0,1,19,883,1991
Yashpal Sharma,INDIA,1978,1985,7,40,0,89,9,28.48,1401,63.02,0,4,0,883,1978
TT Bresnan,ENG,2006,2015,9,64,0,80,20,19.79,965,90.25,0,1,6,871,2006
SHT Kandamby,SL,2004,2014,10,36,1,93,6,29.0,1250,69.6,0,5,2,870,2004
AC Voges,AUS,2007,2013,6,28,1,112,9,45.78,998,87.17,1,4,0,870,2007
DJ Richardson,SA,1991,1998,7,77,0,53,33,19.72,1298,66.87,0,1,6,868,1991
MA Vermeulen,ZIM,2000,2009,9,43,0,92,4,22.25,1227,70.74,0,6,4,868,2000
HK Badani,INDIA,2000,2004,4,36,0,100,10,33.34,1180,73.47,1,4,1,867,2000
GO Jones,ENG/PNG,2004,2014,10,43,0,80,8,24.62,1117,77.17,0,4,1,862,2004
TT Samaraweera,SL,1998,2011,13,42,1,105,11,27.8,1244,69.29,2,0,4,862,1998
SB Smith,AUS,1983,1985,2,24,0,117,2,39.13,1319,65.27,2,8,1,861,1983
DL Amiss,ENG,1972,1977,5,18,0,137,0,47.72,1185,72.48,4,1,0,859,1972
RA Harper,WI,1983,1996,13,73,1,45,20,16.13,1162,73.58,0,0,5,855,1983
WB Phillips,AUS,1982,1986,4,41,1,75,6,24.34,994,85.71,0,6,1,852,1982
CWJ Athey,ENG,1980,1988,8,30,1,142,3,31.4,1495,56.72,2,4,1,848,1980
RS Kalpage,SL,1992,1999,7,69,0,51,28,20.58,1320,63.93,0,1,2,844,1992
MAR Samarasekera,SL,1983,1994,11,39,0,76,2,22.81,1207,69.92,0,4,2,844,1983
D Ganga,WI,1999,2006,7,34,0,71,1,25.54,1414,59.61,0,9,5,843,1999
CA Ingram,SA,2010,2013,3,29,0,124,3,32.42,1024,82.32,3,3,5,843,2010
BM McMillan,SA,1991,1998,7,52,0,127,16,23.36,1147,73.32,1,0,3,841,1991
CK Coventry,ZIM,2003,2015,12,35,1,194,1,24.44,937,88.68,1,3,5,831,2003
Anshuman Rath,HKG,2014,2018,4,18,1,143,2,51.75,1080,76.66,1,7,1,828,2014
PJ Moor,ZIM,2014,2019,5,45,1,58,5,20.67,1225,67.51,0,4,3,827,2014
DW Hookes,AUS,1977,1986,9,36,0,76,2,24.29,1146,72.07,0,5,3,826,1977
PJ Hughes,AUS,2013,2014,1,24,1,138,1,35.91,1100,75.09,2,4,1,826,2013
AI Kallicharran,WI,1973,1981,8,28,0,78,4,34.41,1329,62.15,0,6,0,826,1973
JR Ratnayeke,SL,1982,1990,8,69,0,50,14,14.98,1571,52.45,0,1,4,824,1982
GN Yallop,AUS,1978,1984,6,27,1,66,6,39.19,1288,63.89,0,7,1,823,1978
AC Waller,ZIM,1987,1997,10,38,1,83,3,23.37,1172,69.79,0,4,4,818,1987
DM de Silva,SL,2016,2019,3,39,0,84,7,25.43,1073,75.86,0,4,3,814,2016
Sharjeel Khan,PAK,2013,2017,4,25,0,152,0,32.48,716,113.4,1,6,2,812,2013
YK Pathan,INDIA,2008,2012,4,41,1,123,11,27.0,713,113.6,2,3,7,810,2008
AT Carey,AUS,2018,2019,1,26,0,85,6,40.2,874,91.99,0,4,1,804,2018
JM Davison,CAN,2003,2011,8,32,0,111,2,26.63,767,104.17,1,5,5,799,2003
Aminul Islam,BDESH,1988,2002,14,39,0,70,5,23.35,1403,56.59,0,3,5,794,1988
Z Khan,INDIA,2000,2012,12,101,1,34,35,12.0,1078,73.46,0,0,15,792,2000
GB Hogg,AUS,1996,2008,12,65,1,71,26,20.25,1004,78.68,0,2,9,790,1996
Majid Khan,PAK,1973,1982,9,22,0,109,1,37.42,1052,74.71,1,7,1,786,1973
S Wettimuny,SL,1982,1987,5,33,1,86,1,24.56,1636,48.04,0,4,1,786,1982
Babar Hayat,HKG,2014,2018,4,22,0,89,2,39.2,999,78.47,0,8,3,784,2014
R Lamba,INDIA,1986,1989,3,31,0,102,2,27.0,1166,67.15,1,6,2,783,1986
IH Romaine,BMUDA,2006,2009,3,34,0,101,3,25.25,1222,64.07,1,4,5,783,2006
JA Morkel,SA,2004,2012,8,43,0,97,10,23.69,780,100.25,0,2,1,782,2004
Wasim Raja,PAK,1973,1985,12,45,0,60,10,22.34,1168,66.95,0,2,6,782,1973
Abdur Razzak,BDESH,2004,2014,10,97,1,53,39,13.43,1020,76.37,0,1,12,779,2004
AR White,IRE,2006,2014,8,46,0,79,3,18.04,1235,62.83,0,1,4,776,2006
Liton Das,BDESH,2015,2019,4,33,0,121,2,24.77,871,88.17,1,3,4,768,2015
Saleem Yousuf,PAK,1982,1990,8,62,0,62,19,17.86,1024,75.0,0,4,5,768,1982
CN Evans,ZIM,1992,2002,10,47,1,96,5,18.19,1006,75.94,0,2,3,764,1992
Rizwan Cheema,CAN,2008,2013,5,32,0,94,1,24.64,685,111.53,0,6,3,764,2008
KWR Fletcher,ENG,1971,1982,11,22,0,131,3,39.84,1134,66.75,1,5,0,757,1971
J Dyson,AUS,1980,1983,3,27,0,79,4,32.82,1553,48.61,0,4,1,755,1980
AR Cusack,IRE,2007,2015,8,47,0,71,14,22.57,1159,64.27,0,2,8,745,2007
AG Cremer,ZIM,2009,2018,9,71,0,58,20,14.58,1196,62.2,0,1,7,744,2009
G Fowler,ENG,1983,1986,3,26,1,81,2,31.0,1321,56.32,0,4,2,744,1983
DT Johnston,IRE,2006,2013,7,53,1,45,15,19.55,785,94.64,0,0,3,743,2006
Manzoor Elahi,PAK,1984,1995,11,46,1,50,13,22.45,827,89.6,0,1,1,741,1984
AM Samad,CAN,2003,2009,6,27,0,130,2,29.6,1045,70.81,1,2,2,740,2003
A Vala,PNG,2014,2019,5,27,0,104,0,27.37,1082,68.29,1,2,1,739,2014
PA Patel,INDIA,2003,2012,9,34,0,95,3,23.74,962,76.5,0,4,2,736,2003
Sohaib Maqsood,PAK,2013,2016,3,25,1,89,2,31.95,881,83.42,0,5,1,735,2013
MW Machan,SCOT,2013,2016,3,22,0,114,0,33.36,952,77.1,1,3,1,734,2013
CJ Nevin,NZ,2000,2003,3,36,0,74,0,20.33,1000,73.2,0,4,4,732,2000
N Pooran,WI,2019,2019,0,17,0,118,3,52.0,661,110.13,1,5,1,728,2019
CJ Tavare,ENG,1980,1984,4,28,1,83,2,27.69,1471,48.94,0,4,1,720,1980
TP Ura,PNG,2014,2019,5,26,0,151,0,27.61,892,80.49,1,2,2,718,2014
MA Ealham,ENG,1996,2001,5,45,0,45,4,17.46,1092,65.56,0,0,4,716,1996
IJ Harvey,AUS,1997,2004,7,51,1,48,11,17.87,811,88.16,0,0,2,715,1997
Muhammad Usman,UAE,2016,2019,3,30,0,80,4,27.42,928,76.83,0,3,2,713,2016
Saqlain Mushtaq,PAK,1995,2003,8,98,1,37,38,11.85,1434,49.58,0,0,13,711,1995
LJ Wright,ENG,2007,2014,7,39,0,52,4,20.2,820,86.21,0,2,5,707,2007
Mohammad Rizwan,PAK,2015,2019,4,28,0,115,7,33.57,787,89.58,2,3,1,705,2015
J Mubarak,SL,2002,2013,11,37,0,72,6,22.7,1115,63.13,0,4,1,704,2002
PA Wallace,WI,1991,2000,9,33,0,103,0,21.24,1151,60.9,1,2,4,701,1991
SM Ervine,ZIM,2001,2004,3,34,0,100,7,25.85,816,85.53,1,2,5,698,2001
PL Symcox,SA,1993,1999,6,54,0,61,13,16.92,830,83.61,0,3,6,694,1993
Rameez Shahzad,UAE,2016,2018,2,15,1,121,2,53.15,817,84.57,2,4,1,691,2016
PAJ DeFreitas,ENG,1987,1997,10,66,0,67,23,16.04,823,83.83,0,1,4,690,1987
N Deonarine,WI,2005,2015,10,29,1,65,3,26.23,989,68.95,0,4,0,682,2005
Wahab Riaz,PAK,2008,2019,11,64,1,54,15,13.87,787,86.4,0,2,12,680,2008
JR Murray,WI,1992,1999,7,36,0,86,6,22.6,929,72.98,0,5,4,678,1992
TG Southee,NZ,2008,2019,11,85,0,55,32,12.75,686,98.54,0,1,12,676,2008
R Ashwin,INDIA,2010,2017,7,61,0,65,19,16.07,776,86.98,0,1,6,675,2010
Nizakat Khan,HKG,2014,2018,4,20,0,94,0,33.75,814,82.92,0,3,0,675,2014
M Muralitharan,SL,1993,2011,18,162,1,33,63,6.8,869,77.56,0,0,25,674,1993
IM Chappell,AUS,1971,1980,9,16,0,86,2,48.07,874,77.0,0,8,0,673,1971
DA Marillier,ZIM,2000,2003,3,41,0,100,4,18.16,949,70.81,1,3,4,672,2000
Rohan Mustafa,UAE,2014,2019,5,33,0,109,0,20.33,985,68.12,1,1,3,671,2014
R Powell,WI,2016,2018,2,31,0,101,3,23.92,806,83.12,1,2,2,670,2016
UC Hathurusingha,SL,1992,1999,7,33,0,66,1,20.9,1318,50.75,0,4,3,669,1992
AC Botha,IRE,2006,2011,5,38,0,56,4,19.58,970,68.65,0,2,5,666,2006
HE van der Dussen,SA,2019,2019,0,14,0,95,5,73.77,811,81.87,0,7,0,664,2019
CJ Ferguson,AUS,2009,2011,2,25,1,71,9,41.43,777,85.32,0,5,0,663,2009
LE Plunkett,ENG,2005,2019,14,50,0,56,19,20.83,629,102.7,0,1,3,646,2005
S Ramesh,INDIA,1999,1999,0,24,0,82,1,28.08,1092,59.15,0,6,3,646,1999
AK Markram,SA,2017,2019,2,24,1,67,1,27.95,755,85.16,0,2,1,643,2017
Qasim Umar,PAK,1983,1987,4,31,0,69,3,22.92,1125,57.06,0,4,3,642,1983
Abdul Qadir,PAK,1983,1993,10,68,1,41,26,15.26,849,75.5,0,0,6,641,1983
DL Hemp,BMUDA,2006,2009,3,22,1,102,3,33.73,912,70.28,1,4,4,641,2006
CEL Ambrose,WI,1988,2000,12,96,1,31,36,10.65,985,64.87,0,0,13,639,1988
BMAJ Mendis,SL,2010,2019,9,44,0,72,10,18.7,769,82.7,0,1,2,636,2010
C de Grandhomme,NZ,2012,2019,7,29,1,74,6,27.52,590,107.28,0,3,2,633,2012
JF Reid,NZ,1980,1986,6,24,0,88,1,27.52,1084,58.39,0,4,0,633,1980
DLS van Bunge,NL,2002,2013,11,31,0,80,1,21.1,953,66.42,0,3,2,633,2002
PSP Handscomb,AUS,2017,2019,2,20,0,117,1,33.26,649,97.38,1,4,2,632,2017
RMH Binny,INDIA,1980,1987,7,49,0,57,10,16.12,1046,60.13,0,1,4,629,1980
GR Larsen,NZ,1990,1999,9,70,0,37,27,14.62,970,64.84,0,0,6,629,1990
AM Blignaut,ZIM,1999,2010,11,41,1,63,8,18.96,589,106.28,0,5,3,626,1999
DJ Nash,NZ,1992,2002,10,53,0,42,13,15.6,940,66.38,0,0,3,624,1992
DN Patel,NZ,1987,1997,10,63,0,71,10,11.75,868,71.77,0,1,6,623,1987
RR Patel,KENYA,2008,2014,6,35,0,92,4,20.03,978,63.49,0,2,3,621,2008
GRJ Matthews,AUS,1984,1993,9,50,0,54,13,16.72,911,67.94,0,1,5,619,1984
WV Raman,INDIA,1988,1996,8,27,0,114,1,23.73,1109,55.63,1,3,6,617,1988
GJ Rennie,ZIM,1996,2003,7,37,0,76,6,19.9,928,66.48,0,2,5,617,1996
SFAF Bacchus,WI,1978,1983,5,26,1,80,3,26.6,928,65.94,0,3,2,612,1978
RJ Ratnayake,SL,1982,1993,11,55,1,33,18,16.54,705,86.8,0,0,4,612,1982
J Botha,SA,2005,2012,7,50,0,46,18,19.03,710,85.77,0,0,2,609,2005
D Gough,ENG,1994,2006,12,87,1,46,38,12.42,947,64.3,0,0,10,609,1994
AJ Hollioake,ENG,1996,1999,3,30,1,83,6,25.25,807,75.09,0,3,1,606,1996
RW Chakabva,ZIM,2008,2019,11,35,1,78,2,18.15,1017,58.89,0,1,2,599,2008
RIC Holder,WI,1993,1997,4,31,0,65,6,23.96,876,68.37,0,2,4,599,1993
RT Robinson,ENG,1984,1988,4,26,0,83,0,22.96,1026,58.18,0,3,2,597,1984
BM Laird,AUS,1979,1982,3,23,1,117,3,29.7,1105,53.75,1,2,0,594,1979
Mansoor Akhtar,PAK,1980,1990,10,35,0,47,1,17.44,1148,51.65,0,0,1,593,1980
W Larkins,ENG,1979,1991,12,24,0,124,0,24.62,1047,56.44,1,0,3,591,1979
LOB Cann,BMUDA,2006,2009,3,25,0,52,3,26.81,504,117.06,0,1,3,590,2006
AU Rashid,ENG,2009,2019,10,43,0,69,12,18.96,574,102.43,0,1,4,588,2009
FDM Karunaratne,SL,2011,2019,8,24,0,97,2,26.63,801,73.15,0,4,3,586,2011
RJ Nicol,NZ,2011,2013,2,21,0,146,2,30.84,776,75.51,2,2,2,586,2011
SB Joshi,INDIA,1996,2001,5,45,1,61,11,17.17,653,89.43,0,1,4,584,1996
RT Latham,NZ,1990,1994,4,33,0,60,4,20.1,1008,57.83,0,1,3,583,1990
Khurram Khan,UAE,2004,2015,11,16,1,132,2,41.57,725,80.27,1,3,0,582,2004
R Mutumbami,ZIM,2014,2019,5,31,0,74,2,20.06,814,71.49,0,3,3,582,2014
JL Carter,WI,2015,2019,4,28,0,54,3,23.24,822,70.68,0,3,1,581,2015
GH Dockrell,IRE,2010,2019,9,57,1,62,22,16.54,835,69.34,0,2,5,579,2010
DAS Gunaratne,SL,2016,2019,3,25,1,114,4,27.38,724,79.41,1,1,0,575,2016
BJ Hodge,AUS,2005,2007,2,21,0,123,2,30.26,657,87.51,1,3,3,575,2005
MJR Rindel,SA,1994,1999,5,22,0,106,1,27.38,860,66.86,1,2,1,575,1994
Tushar Imran,BDESH,2001,2007,6,40,0,65,0,14.35,970,59.17,0,2,8,574,2001
BJ Watling,NZ,2010,2018,8,25,1,96,2,24.91,838,68.37,0,5,3,573,2010
C White,ENG,1994,2003,9,41,1,57,5,15.77,928,61.2,0,1,9,568,1994
SL Malinga,SL,2004,2019,15,119,0,56,36,6.83,761,74.5,0,1,26,567,2004
RM Haq,SCOT,2006,2015,9,40,0,71,6,16.64,931,60.79,0,3,6,566,2006
KS More,INDIA,1984,1993,9,65,1,42,22,13.09,808,69.67,0,0,5,563,1984
HG Munsey,SCOT,2017,2019,2,25,0,61,3,25.54,732,76.77,0,2,3,562,2017
CR Brathwaite,WI,2011,2019,8,37,0,101,3,16.44,614,91.04,1,1,2,559,2011
Mominul Haque,BDESH,2012,2018,6,26,0,60,1,22.28,749,74.36,0,3,1,557,2012
Aamer Malik,PAK,1988,1994,6,23,0,90,1,25.27,989,56.21,0,5,1,556,1988
RJ Peterson,SA,2002,2014,12,41,0,68,14,20.59,688,80.81,0,1,4,556,2002
GS Blewett,AUS,1995,1999,4,30,1,57,3,20.4,889,61.97,0,2,3,551,1995
JN Mohammed,WI,2011,2018,7,24,1,91,1,23.95,795,69.3,0,4,2,551,2011
Mosaddek Hossain,BDESH,2016,2019,3,30,1,52,10,27.45,633,86.72,0,2,1,549,2016
AL Phehlukwayo,SA,2016,2019,3,32,1,69,15,32.29,610,90.0,0,1,3,549,2016
TJ Friend,ZIM,2000,2004,4,39,0,91,5,16.11,724,75.69,0,3,5,548,2000
T Duffin,ZIM,2006,2007,1,23,0,88,0,23.73,993,54.98,0,3,1,546,2006
Mohammad Wasim,PAK,1996,2000,4,25,0,76,2,23.6,1043,52.06,0,3,4,543,1996
XM Marshall,USA/WI,2005,2019,14,33,1,157,3,18.06,810,66.91,1,1,6,542,2005
AP Kuiper,SA,1991,1996,5,23,1,63,7,33.68,662,81.41,0,3,0,539,1991
P Willey,ENG,1977,1986,9,24,0,64,1,23.39,855,62.92,0,5,3,538,1977
MC Snedden,NZ,1980,1990,10,54,0,64,19,15.28,843,63.46,0,1,4,535,1980
Athar Ali Khan,BDESH,1988,1998,10,19,0,82,1,29.55,945,56.29,0,3,3,532,1988
IS Billcliff,CAN,2003,2009,6,19,0,93,0,27.84,793,66.7,0,4,0,529,2003
SCJ Broad,ENG,2006,2016,10,68,1,45,25,12.3,709,74.61,0,0,8,529,2006
NN Odhiambo,KENYA,2006,2014,8,53,0,66,9,12.0,737,71.64,0,1,9,528,2006
B Kumar,INDIA,2012,2019,7,52,1,53,15,14.21,703,74.82,0,1,8,526,2012
Naved-ul-Hasan,PAK,2003,2010,7,51,0,33,18,15.87,620,84.51,0,0,4,524,2003
Amjad Ali,UAE,2008,2015,7,17,0,98,0,30.58,680,76.47,0,3,0,520,2008
LK Germon,NZ,1994,1997,3,31,0,89,5,19.96,787,65.94,0,3,2,519,1994
Mudassar Bukhari,NL,2007,2014,7,34,0,71,4,17.2,671,76.9,0,2,4,516,2007
TAM Siriwardana,SL,2015,2019,4,24,0,66,1,22.43,525,98.28,0,3,1,516,2015
KM Dabengwa,ZIM,2005,2010,5,34,0,45,7,19.03,851,60.39,0,0,4,514,2005
PK Amre,INDIA,1991,1994,3,30,1,84,5,20.52,799,64.2,0,2,1,513,1991
Dawlat Zadran,AFG,2011,2019,8,56,1,47,27,17.68,664,77.25,0,0,7,513,2011
KD Walters,AUS,1971,1981,10,24,0,59,6,28.5,732,70.08,0,2,1,513,1971
JG Bracewell,NZ,1983,1990,7,43,0,43,12,16.51,717,71.4,0,0,6,512,1983
DP Viljoen,ZIM,1997,2001,4,43,1,63,7,14.22,827,61.91,0,2,5,512,1997
JM Brearley,ENG,1977,1980,3,24,0,78,3,24.28,1120,45.53,0,3,6,510,1977
WD Parnell,SA,2009,2017,8,38,0,56,14,21.16,648,78.39,0,1,3,508,2009
AO Suji,KENYA,1996,2008,12,46,0,67,7,12.97,977,51.79,0,1,1,506,1996
AN Petersen,SA,2006,2013,7,19,0,80,1,28.0,610,82.62,0,4,0,504,2006
Taufeeq Umar,PAK,2001,2011,10,22,1,81,1,24.0,895,56.31,0,3,0,504,2001
PR Reiffel,AUS,1992,1999,7,57,0,58,21,13.97,709,70.94,0,1,5,503,1992
AR Nurse,WI,2016,2019,3,40,0,44,14,19.3,513,97.85,0,0,2,502,2016
JE Emburey,ENG,1980,1993,13,45,0,34,10,14.31,664,75.45,0,0,3,501,1980
Ghulam Shabber,UAE,2017,2019,2,23,0,90,0,21.73,800,62.5,0,4,2,500,2017
GP Swann,ENG,2000,2013,13,48,0,34,12,13.88,553,90.41,0,0,3,500,2000
JH Davey,SCOT,2010,2019,9,28,0,64,6,22.59,742,66.98,0,2,2,497,2010
JJ Tucker,BMUDA,2006,2009,3,26,0,52,1,19.84,726,68.31,0,1,1,496,2006
DJ Callaghan,SA,1992,2000,8,25,1,169,6,25.94,726,67.9,1,0,2,493,1992
Mohammad Mithun,BDESH,2014,2019,5,21,0,63,2,25.94,659,74.81,0,4,1,493,2014
Naimur Rahman,BDESH,1995,2002,7,27,0,47,2,19.52,771,63.29,0,0,3,488,1995
JWM Dalrymple,ENG,2006,2007,1,26,0,67,1,19.48,672,72.47,0,2,2,487,2006
AC Cummins,CAN/WI,1991,2007,16,49,1,44,13,13.5,586,82.93,0,0,4,486,1991
R McLaren,SA,2009,2014,5,41,1,71,15,18.65,680,71.32,0,1,3,485,2009
MRJ Veletta,AUS,1987,1989,2,19,1,68,4,32.26,642,75.38,0,2,2,484,1987
CS Baugh,WI,2003,2012,9,35,0,49,11,20.08,719,67.03,0,0,2,482,2003
AA Mulla,CAN,2006,2009,3,24,0,58,0,20.08,595,81.0,0,1,2,482,2006
SR Patel,ENG,2008,2013,5,22,1,70,7,32.13,517,93.23,0,1,1,482,2008
CD Wallace,SCOT,2012,2019,7,24,0,58,1,20.95,527,91.46,0,4,1,482,2012
DJ Reekers,NL,2006,2009,3,19,0,104,0,25.31,411,117.03,1,0,3,481,2006
TN de Grooth,NL,2006,2013,7,32,0,97,4,17.14,774,62.01,0,1,1,480,2006
DA Minors,BMUDA,2006,2007,1,20,0,68,2,26.55,791,60.42,0,3,1,478,2006
BG Rogers,ZIM,2002,2005,3,15,0,84,0,31.86,689,69.37,0,5,2,478,2002
S Lee,AUS,1995,2001,6,35,0,47,8,17.66,500,95.4,0,0,3,477,1995
SS Iyer,INDIA,2017,2019,2,10,0,88,0,47.6,454,104.84,0,6,0,476,2017
Karim Sadiq,AFG,2009,2016,7,22,1,114,2,23.75,587,80.91,2,0,3,475,2009
MA Leask,SCOT,2014,2019,5,28,1,59,6,21.54,437,108.46,0,3,1,474,2014
CA Best,WI,1986,1992,6,23,0,100,4,24.89,690,68.55,1,2,2,473,1986
AJ Bichel,AUS,1997,2004,7,36,0,64,13,20.47,600,78.5,0,1,5,471,1997
L Siaka,PNG,2014,2019,5,25,0,109,0,18.84,626,75.23,1,1,4,471,2014
H Patel,CAN,2009,2013,4,23,0,62,1,21.27,584,80.13,0,2,3,468,2009
MD Shanaka,SL,2016,2019,3,19,0,68,1,26.0,404,115.84,0,3,1,468,2016
CH Morris,SA,2013,2019,6,27,0,62,4,20.3,465,100.43,0,1,0,467,2013
ALF de Mel,SL,1982,1987,5,41,0,36,9,14.56,595,78.31,0,0,6,466,1982
AO Malhotra,INDIA,1982,1986,4,19,0,65,4,30.46,645,70.85,0,1,0,457,1982
Umar Gul,PAK,2003,2016,13,65,0,39,18,9.72,642,71.18,0,0,10,457,2003
C Sharma,INDIA,1983,1994,11,35,1,101,16,24.0,504,90.47,1,0,3,456,1983
GEF Barnett,CAN,2006,2010,4,22,0,77,0,20.68,745,61.07,0,1,1,455,2006
R Gunasekera,CAN,2008,2014,6,19,0,72,0,23.94,677,67.2,0,6,3,455,2008
RR Hendricks,SA,2018,2019,1,18,0,102,1,26.76,591,76.98,1,2,1,455,2018
MD Dai,PNG,2014,2018,4,18,1,76,2,28.37,585,77.6,0,3,1,454,2014
Minhajul Abedin,BDESH,1986,1999,13,26,1,68,2,18.87,909,49.83,0,2,3,453,1986
Mehrab Hossain,BDESH,1998,2003,5,18,0,101,0,24.94,763,58.84,1,2,2,449,1998
WIA Fernando,SL,2016,2019,3,15,0,104,0,29.8,464,96.33,1,2,2,447,2016
TE Blain,NZ,1986,1994,8,38,1,49,11,16.37,662,66.76,0,0,6,442,1986
SAR Silva,SL,1984,1985,1,20,0,85,0,22.05,838,52.62,0,3,1,441,1984
MK Pandey,INDIA,2015,2018,3,18,1,104,6,36.66,479,91.85,1,2,2,440,2015
GR Viswanath,INDIA,1974,1982,8,23,0,75,1,19.95,830,52.89,0,2,1,439,1974
RL Chase,WI,2017,2019,2,18,0,94,2,27.37,575,76.17,0,2,2,438,2017
JP Maher,AUS,1998,2003,5,20,0,95,3,25.76,673,65.08,0,1,1,438,1998
AH Omarshah,ZIM,1983,1996,13,28,1,60,2,16.8,860,50.81,0,1,4,437,1983
PL Taylor,AUS,1987,1992,5,47,1,54,25,19.86,583,74.95,0,1,4,437,1987
DN Chudasama,KENYA,1996,1999,3,19,0,122,0,22.84,685,63.35,1,1,2,434,1996
CJ McDermott,AUS,1985,1996,11,78,0,37,17,7.08,492,87.8,0,0,15,432,1985
CJO Smith,SCOT,2006,2009,3,26,0,59,4,19.63,640,67.5,0,2,3,432,2006
Shafiqullah,AFG,2009,2018,9,21,0,56,2,22.63,408,105.39,0,2,4,430,2009
DR Pringle,ENG,1982,1993,11,30,1,49,12,23.61,616,68.99,0,0,1,425,1982
MN van Wyk,SA,2003,2015,12,17,0,82,1,26.56,617,68.88,0,4,2,425,2003
AK Sharma,INDIA,1988,1993,5,27,1,59,6,20.19,469,90.4,0,3,2,424,1988
RC Russell,ENG,1987,1998,11,31,0,50,7,17.62,638,66.3,0,1,0,423,1987
AS Hansra,CAN,2010,2014,4,22,1,70,4,23.38,725,58.06,0,2,2,421,2010
S Prasanna,SL,2011,2019,8,37,0,95,3,12.38,445,94.6,0,2,7,421,2011
SMA Priyanjan,SL,2013,2015,2,20,0,74,2,23.33,522,80.45,0,2,0,420,2013
AR Adams,NZ,2001,2007,6,34,0,45,10,17.45,417,100.47,0,0,1,419,2001
SR Waters,KENYA,2008,2011,3,20,0,74,0,20.95,751,55.79,0,2,2,419,2008
CO Browne,WI,1995,2005,10,32,1,46,8,17.29,590,70.33,0,0,3,415,1995
Farhad Reza,BDESH,2006,2011,5,31,0,50,6,16.48,636,64.77,0,1,2,412,2006
Usman Ghani,AFG,2014,2017,3,15,0,118,0,27.4,520,79.03,1,2,2,411,2014
GB Brent,ZIM,1996,2008,12,54,1,59,20,12.0,698,58.45,0,1,3,408,1996
CB Lambert,USA/WI,1990,2004,14,12,0,119,0,33.91,540,75.37,1,2,1,407,1990
RW Price,ZIM,2002,2012,10,59,0,46,17,9.66,701,57.91,0,0,10,406,2002
IR Bishop,WI,1988,1997,9,44,1,33,19,16.2,776,52.19,0,0,3,405,1988
EA Brandes,ZIM,1987,1999,12,41,0,55,10,13.03,448,90.17,0,2,3,404,1987
ID Blackwell,ENG,2002,2006,4,29,0,82,2,14.92,465,86.66,0,1,6,403,2002
F Mutizwa,ZIM,2009,2011,2,15,0,79,2,31.0,502,80.27,0,4,2,403,2009
JP Bray,IRE,2006,2007,1,15,0,116,1,28.64,594,67.5,2,0,2,401,2006
RG de Alwis,SL,1983,1988,5,27,1,59,8,21.1,512,78.32,0,2,2,401,1983
S Madan Lal,INDIA,1974,1987,13,35,1,53,14,19.09,645,62.17,0,1,1,401,1974
TBM de Leede,NL,1996,2007,11,25,1,58,1,16.66,628,63.69,0,2,4,400,1996
WS Jayantha,SL,2004,2004,0,17,1,74,2,26.66,530,75.47,0,2,2,400,2004
Mushtaq Ahmed,PAK,1989,2003,14,76,1,34,34,9.5,698,57.16,0,0,10,399,1989
Sohail Tanvir,PAK,2007,2014,7,40,0,59,11,13.75,458,87.11,0,1,3,399,2007
DR Chumney,CAN,2003,2007,4,21,0,48,2,20.89,595,66.72,0,0,0,397,2003
Mohammad Naveed,UAE,2014,2019,5,34,0,45,10,16.54,323,122.91,0,0,2,397,2014
IA Karim,KENYA,2011,2014,3,9,0,112,0,44.0,522,75.86,2,1,0,396,2011
AB Barath,WI,2010,2012,2,14,0,113,1,30.3,612,64.37,1,1,2,394,2010
Shoaib Akhtar,PAK,1998,2011,13,84,0,43,40,8.95,538,73.23,0,0,11,394,1998
T Thushara,SL,2008,2010,2,27,1,54,6,18.66,424,92.45,0,1,4,392,2008
PJ Ongondo,KENYA,1999,2011,12,62,0,36,19,9.09,621,62.96,0,0,9,391,1999
Mirwais Ashraf,AFG,2009,2016,7,38,1,52,11,14.33,543,71.27,0,1,3,387,2009
AF Giles,ENG,1997,2005,8,35,0,41,13,17.5,551,69.87,0,0,2,385,1997
Hannan Sarkar,BDESH,2002,2004,2,20,0,61,0,19.15,713,53.71,0,3,2,383,2002
Sadiq Mohammad,PAK,1973,1980,7,19,0,74,1,21.27,755,50.72,0,2,0,383,1973
Mehidy Hasan Miraz,BDESH,2017,2019,2,24,0,51,4,19.05,498,76.5,0,1,0,381,2017
MH Dekker,ZIM,1992,1996,4,22,0,79,2,18.95,798,47.49,0,2,0,379,1992
DM Wellham,AUS,1981,1987,6,17,0,97,2,25.26,699,54.22,0,1,0,379,1981
S Bau,PNG,2016,2019,3,21,0,59,1,18.9,602,62.79,0,1,4,378,2016
U Bhatti,CAN,2006,2010,4,30,0,46,8,17.18,513,73.68,0,0,2,378,2006
GF Lawson,AUS,1980,1989,9,52,1,33,18,11.11,500,75.6,0,0,9,378,1980
MR Ramprakash,ENG,1991,2001,10,18,0,51,4,26.85,544,69.11,0,1,0,376,1991
Al Sahariar,BDESH,1999,2003,4,29,1,62,1,13.35,709,52.75,0,2,6,374,1999
CC Lewis,ENG,1990,1998,8,40,0,33,14,14.38,459,81.48,0,0,6,374,1990
SMH Kirmani,INDIA,1976,1986,10,31,1,48,13,20.72,616,60.55,0,0,2,373,1976
DS de Silva,SL,1975,1985,10,29,1,37,10,19.52,691,53.69,0,0,0,371,1975
S Chattergoon,WI,2006,2009,3,17,1,54,2,24.66,615,60.16,0,2,2,370,2006
PJ Forrest,AUS,2012,2012,0,14,0,104,0,26.28,561,65.59,1,3,2,368,2012
DW Steyn,SA,2005,2019,14,51,0,60,12,9.35,562,64.94,0,1,8,365,2005
WM Darling,AUS,1978,1982,4,18,0,74,1,21.35,679,53.46,0,1,0,363,1978
Mohammad Amir,PAK,2009,2019,10,30,1,73,10,18.15,444,81.75,0,2,5,363,2009
SP Narine,WI,2011,2016,5,45,0,36,12,11.0,441,82.31,0,0,8,363,2011
SS Karim,INDIA,1997,2000,3,27,0,55,4,15.73,560,64.64,0,1,2,362,1997
R Rampaul,WI,2003,2015,12,40,1,86,11,12.48,472,76.69,0,1,3,362,2003
Shahriar Hossain,BDESH,1997,2004,7,19,0,95,0,19.05,682,53.07,0,2,4,362,1997
SW Ambris,WI,2017,2019,2,8,0,148,2,60.16,354,101.97,1,1,0,361,2017
Asif Ali,PAK,2018,2019,1,14,0,52,1,27.76,280,128.92,0,3,0,361,2018
DG Brownlie,NZ,2012,2017,5,15,0,63,1,25.78,486,74.27,0,1,0,361,2012
Hazratullah Zazai,AFG,2018,2019,1,16,0,67,0,22.56,409,88.26,0,2,1,361,2018
WK McCallan,IRE,2006,2009,3,28,1,50,10,20.05,419,86.15,0,1,5,361,2006
RC Irani,ENG,1996,2003,7,30,0,53,5,14.4,549,65.57,0,1,7,360,1996
Mushfiqur Rahman,BDESH,2000,2004,4,25,0,49,3,16.36,690,52.17,0,0,4,360,2000
BJ Patel,KENYA,2001,2006,5,25,0,44,3,16.36,736,48.91,0,0,4,360,2001
AD Brown,ENG,1996,2001,5,16,0,118,0,22.12,427,82.9,1,1,2,354,1996
ADS Fletcher,WI,2008,2016,8,25,0,54,0,14.16,549,64.48,0,2,3,354,2008
Nasir Jamal,AFG,2014,2018,4,14,0,53,1,27.07,537,65.54,0,3,1,352,2014
Wajahatullah Wasti,PAK,1999,2000,1,15,0,84,0,23.26,713,48.94,0,1,1,349,1999
Aaron Jones,USA,2019,2019,0,9,0,95,0,38.66,521,66.79,0,3,1,348,2019
MA Starc,AUS,2010,2019,9,46,1,52,18,12.42,389,89.46,0,1,7,348,2010
Zahid Fazal,PAK,1990,1994,4,18,1,98,3,23.2,584,59.58,0,2,0,348,1990
RR Pant,INDIA,2018,2019,1,13,0,71,0,26.61,328,105.48,0,1,1,346,2018
RDB Croft,ENG,1996,2001,5,36,0,32,12,14.37,519,66.47,0,0,4,345,1996
Ashfaq Ahmed,UAE,2018,2019,1,16,0,92,0,21.5,387,88.88,0,2,1,344,2018
GP Wickramasinghe,SL,1990,2002,12,64,0,32,24,8.6,543,63.35,0,0,12,344,1990
DNT Zoysa,SL,1997,2007,10,47,1,47,21,13.19,358,95.81,0,0,5,343,1997
HH Kanitkar,INDIA,1997,2000,3,27,0,57,8,17.84,512,66.21,0,1,2,339,1997
M Vijay,INDIA,2010,2015,5,16,0,72,0,21.18,506,66.99,0,1,0,339,2010
BE Congdon,NZ,1973,1978,5,9,0,101,3,56.33,472,71.61,1,2,0,338,1973
CM Old,ENG,1973,1981,8,25,1,51,7,18.77,401,84.28,0,1,4,338,1973
Shadab Khan,PAK,2017,2019,2,22,0,54,9,25.92,491,68.63,0,3,2,337,2017
MG Burgess,NZ,1973,1981,8,20,0,47,0,16.8,515,65.24,0,0,1,336,1973
NM Hauritz,AUS,2002,2011,9,32,1,53,17,22.4,349,96.27,0,1,0,336,2002
SD Outerbridge,BMUDA,2006,2009,3,23,0,56,0,14.6,612,54.9,0,1,4,336,2006
Tapash Baisya,BDESH,2002,2007,5,41,1,35,13,12.0,576,58.33,0,0,4,336,2002
SS Pathirana,SL,2015,2017,2,14,0,56,1,25.53,383,86.68,0,1,0,332,2015
KA Edwards,WI,2011,2014,3,16,1,123,2,23.64,494,67.0,1,0,3,331,2011
Manjural Islam Rana,BDESH,2003,2006,3,21,0,63,5,20.68,668,49.55,0,1,1,331,2003
S Mukuddem,BMUDA,2006,2007,1,18,0,57,4,23.64,650,50.92,0,1,2,331,2006
Adnan Mufti,UAE,2017,2018,1,16,1,57,4,27.5,409,80.68,0,1,0,330,2017
Asif Iqbal,PAK,1973,1979,6,8,0,62,2,55.0,466,70.81,0,5,0,330,1973
ZE Surkari,CAN,2008,2011,3,22,0,49,3,17.26,656,50.0,0,0,1,328,2008
DJ Capel,ENG,1987,1990,3,19,1,50,2,19.23,479,68.26,0,1,0,327,1987
MH Yardy,ENG,2006,2011,5,24,1,60,8,20.37,472,69.06,0,2,1,326,2006
ML Nkala,ZIM,1998,2006,8,35,0,47,5,10.8,526,61.59,0,0,5,324,1998
Saeed Ajmal,PAK,2008,2015,7,70,0,33,24,7.04,535,60.56,0,0,11,324,2008
RP Snell,SA,1991,1996,5,28,0,63,8,16.1,330,97.57,0,2,1,322,1991
KJJ van Noortwijk,NL,1996,2003,7,9,1,134,2,46.0,428,75.23,1,1,1,322,1996
Anwar Ali,PAK,2013,2016,3,16,1,43,5,29.18,367,87.46,0,0,0,321,2013
CA Walsh,WI,1985,2000,15,79,0,30,33,6.97,451,71.17,0,0,11,321,1985
RB McCosker,AUS,1975,1982,7,14,0,95,0,22.85,623,51.36,0,2,2,320,1975
DR Brown,ENG/SCOT,1997,2007,10,24,1,50,6,17.72,481,66.32,0,1,3,319,1997
HP Rinke,ZIM,2006,2006,0,18,0,72,0,17.61,378,83.86,0,3,2,317,2006
Faisal Iqbal,PAK,2000,2006,6,16,1,100,2,22.42,519,60.5,1,0,3,314,2000
NAM McLean,WI,1996,2003,7,34,1,50,8,12.07,383,81.98,0,1,7,314,1996
Mohammad Sami,PAK,2001,2015,14,46,0,46,19,11.62,490,64.08,0,0,5,314,2001
B Wood,ENG,1972,1982,10,12,1,78,2,31.4,647,48.53,0,2,1,314,1972
VV Morea,PNG,2014,2018,4,13,1,65,1,26.08,460,68.04,0,3,1,313,2014
RC Fredericks,WI,1973,1977,4,12,0,105,0,25.91,440,70.68,1,1,0,311,1973
BR Hartland,NZ,1992,1994,2,16,1,68,1,20.73,623,49.91,0,2,1,311,1992
Chirag Suri,UAE,2018,2019,1,14,0,67,0,22.14,545,56.88,0,2,3,310,2018
N Chopra,INDIA,1998,2000,2,26,0,61,6,15.5,498,62.24,0,1,1,310,1998
BC Hollioake,ENG,1997,2002,5,17,0,63,2,20.6,381,81.1,0,2,3,309,1997
Nafees Iqbal,BDESH,2003,2005,2,16,0,58,0,19.31,568,54.4,0,2,1,309,2003
KAJ Roach,WI,2008,2019,11,57,0,34,34,13.39,576,53.47,0,0,8,308,2008
Ihsanullah,AFG,2017,2018,1,16,1,57,2,21.92,440,69.77,0,3,2,307,2017
DM Benkenstein,SA,1998,2002,4,20,0,69,3,17.94,463,65.87,0,1,3,305,1998
TK Musakanda,ZIM,2016,2018,2,15,0,60,1,21.71,382,79.58,0,1,1,304,2016
LE Bosman,SA,2006,2010,4,12,0,88,0,25.08,305,98.68,0,2,2,301,2006
CMW Read,ENG,2000,2006,6,24,1,30,7,17.64,410,73.17,0,0,4,300,2000
WKM Benjamin,WI,1986,1995,9,52,0,31,12,7.45,406,73.39,0,0,10,298,1986
GS Ballance,ENG,2013,2015,2,15,0,79,1,21.21,443,67.04,0,2,1,297,2013
PA Nixon,ENG,2007,2007,0,18,0,49,4,21.21,347,85.59,0,0,2,297,2007
Zahoor Elahi,PAK,1996,1997,1,14,0,86,1,22.84,507,58.57,0,3,3,297,1996
CJA Amini,PNG,2014,2019,5,15,1,61,1,21.14,430,68.83,0,2,1,296,2014
DN Crookes,SA,1994,2000,6,23,0,54,3,14.8,412,71.84,0,1,3,296,1994
AJ Pycroft,ZIM,1983,1992,9,19,0,61,2,17.35,560,52.67,0,2,2,295,1983
DR Tuffey,NZ,2000,2010,10,52,0,36,21,9.51,372,79.3,0,0,7,295,2000
DL Murray,WI,1973,1980,7,17,1,61,5,24.5,468,62.82,0,2,0,294,1973
SJ Myburgh,NL,2011,2018,7,13,0,56,1,24.5,339,86.72,0,2,2,294,2011
JL Denly,ENG,2009,2019,10,11,0,67,0,26.63,447,65.54,0,2,0,293,2009
SE Bond,NZ,2002,2010,8,40,1,31,22,16.22,384,76.04,0,0,2,292,2002
P Kumar,INDIA,2007,2012,5,33,1,54,12,13.9,331,88.21,0,1,2,292,2007
SM Sharif,SCOT,2011,2019,8,33,0,34,16,17.17,394,74.11,0,0,3,292,2011
Tanwir Afzal,HKG,2014,2018,4,19,0,73,3,18.25,255,114.5,0,1,3,292,2014
RN Lewis,WI,1997,2009,12,21,0,49,5,18.18,367,79.29,0,0,1,291,1997
DA Reeve,ENG,1991,1996,5,21,0,35,9,24.25,389,74.8,0,0,0,291,1991
CS Pandit,INDIA,1986,1992,6,23,1,33,9,20.71,400,72.5,0,0,2,290,1986
Sanwar Hossain,BDESH,1998,2003,5,27,0,52,2,11.6,597,48.57,0,1,2,290,1998
SMSM Senanayake,SL,2012,2015,3,33,0,42,11,13.18,311,93.24,0,0,6,290,2012
JN Gillespie,AUS,1996,2005,9,39,1,44,16,12.56,368,78.53,0,0,8,289,1996
IDR Bradshaw,WI,2004,2007,3,34,0,37,11,12.47,480,59.79,0,0,6,287,2004
KM Curran,ZIM,1983,1987,4,11,0,73,0,26.09,430,66.74,0,2,1,287,1983
LG Howell,NZ,1998,1998,0,12,0,68,0,23.91,388,73.96,0,4,1,287,1998
MK Tiwary,INDIA,2008,2015,7,12,1,104,1,26.09,403,71.21,1,1,0,287,2008
D Lloyd,ENG,1973,1980,7,8,1,116,1,40.71,526,54.18,1,0,0,285,1973
VJ Marks,ENG,1980,1988,8,24,0,44,3,13.57,434,65.66,0,0,0,285,1980
JAR Blain,SCOT,1999,2009,10,25,0,41,6,14.94,517,54.93,0,0,3,284,1999
NO Miller,WI,2008,2018,10,27,0,51,13,20.28,359,79.1,0,1,4,284,2008
LP van Troost,NL,2002,2007,5,20,0,40,2,15.77,456,62.28,0,0,2,284,2002
A Dananjaya,SL,2012,2019,7,27,1,50,5,12.86,411,68.85,0,1,2,283,2012
MA Holding,WI,1976,1987,11,42,0,64,11,9.09,377,74.8,0,2,9,282,1976
MA Jones,SCOT,2018,2019,1,8,0,87,0,35.12,401,70.07,0,3,0,281,2018
Hasan Ali,PAK,2016,2019,3,29,0,59,9,14.0,247,113.36,0,2,3,280,2016
S Randiv,SL,2009,2016,7,18,0,56,2,17.5,382,73.29,0,1,2,280,2009
CL King,WI,1976,1980,4,14,0,86,2,23.33,267,104.86,0,1,2,280,1976
RS Sodhi,INDIA,2000,2002,2,14,0,67,3,25.45,381,73.49,0,2,0,280,2000
DJ Willey,ENG,2015,2019,4,27,0,50,12,18.6,339,82.3,0,1,1,279,2015
KC Brathwaite,WI,2016,2017,1,10,0,78,0,27.8,483,57.55,0,1,0,278,2016
JE Taylor,WI,2003,2017,14,42,1,43,9,8.42,323,86.06,0,0,7,278,2003
AV Vadher,KENYA,1997,1999,2,16,1,73,6,27.8,512,54.29,0,2,1,278,1997
Mehrab Hossain jnr,BDESH,2006,2009,3,16,0,54,0,17.25,642,42.99,0,1,1,276,2006
JM Anderson,ENG,2002,2015,13,79,0,28,43,7.58,561,48.66,0,0,10,273,2002
DT Christian,AUS,2012,2014,2,18,0,39,5,21.0,307,88.92,0,0,0,273,2012
GH Worker,NZ,2015,2018,3,10,0,58,2,34.0,379,71.76,0,3,0,272,2015
SW Billings,ENG,2015,2018,3,12,0,62,0,22.58,298,90.93,0,2,1,271,2015
JW Hastings,AUS,2010,2017,7,21,0,51,11,27.1,273,99.26,0,1,1,271,2010
DT Tiripano,ZIM,2014,2019,5,22,0,44,6,16.93,468,57.9,0,0,1,271,2014
Umar Amin,PAK,2010,2018,8,16,0,59,1,18.06,392,69.13,0,1,0,271,2010
AM Bacher,SA,1997,2005,8,13,0,56,0,20.76,469,57.56,0,1,0,270,1997
Jahurul Islam,BDESH,2010,2013,3,13,0,53,1,22.5,371,72.77,0,1,2,270,2010
KBJ Azad,INDIA,1980,1986,6,21,1,39,2,14.15,400,67.25,0,0,3,269,1980
AD Gaekwad,INDIA,1975,1987,12,14,1,78,1,20.69,509,52.84,0,1,2,269,1975
AW Greig,ENG,1972,1977,5,19,0,48,3,16.81,378,71.16,0,0,1,269,1972
M Morkel,SA,2007,2018,11,47,1,32,18,9.24,354,75.7,0,0,9,268,2007
Aaqib Javed,PAK,1988,1998,10,51,1,45,26,10.68,456,58.55,0,0,7,267,1988
Shamsur Rahman,BDESH,2013,2014,1,10,0,96,0,26.6,350,76.0,0,2,2,266,2013
CA Soper,PNG,2016,2019,3,19,0,39,4,17.66,496,53.42,0,0,1,265,2016
JM Vince,ENG,2015,2019,4,11,0,51,0,24.09,299,88.62,0,1,1,265,2015
Afsar Zazai,AFG,2014,2017,3,16,0,60,1,17.6,488,54.09,0,2,3,264,2014
MH Denness,ENG,1973,1975,2,11,0,66,2,29.33,417,63.3,0,1,1,264,1973
S Jyoti,CAN,2006,2010,4,13,0,117,1,22.0,442,59.72,1,0,3,264,2006
SP Patil,UAE,2014,2015,1,12,1,99,2,26.3,404,65.09,0,2,1,263,2014
HJW Gardiner,SCOT,2013,2015,2,11,0,96,0,23.81,396,66.16,0,2,1,262,2013
Mohammad Saifuddin,BDESH,2017,2019,2,12,1,51,3,29.11,322,81.36,0,2,1,262,2017
Naved Latif,PAK,2001,2003,2,11,0,113,0,23.81,417,62.82,1,0,1,262,2001
Aizaz Khan,HKG,2014,2018,4,15,0,44,2,20.0,374,69.51,0,0,1,260,2014
MD Patel,USA,2019,2019,0,9,0,82,1,32.5,392,66.32,0,2,3,260,2019
AR McBrine,IRE,2014,2019,5,25,0,79,9,16.18,356,72.75,0,1,1,259,2014
K Rabada,SA,2015,2019,4,28,1,31,12,16.18,333,77.77,0,0,2,259,2015
Ahmed Raza,UAE,2014,2019,5,24,0,50,4,12.9,463,55.72,0,1,4,258,2014
KJ Wadsworth,NZ,1973,1976,3,10,0,104,1,28.66,334,77.24,1,0,1,258,1973
ML Udawatte,SL,2008,2008,0,9,0,73,0,28.55,383,67.1,0,2,1,257,2008
SS Dighe,INDIA,2000,2001,1,17,1,94,6,23.27,421,60.8,0,1,1,256,2000
R Edwards,AUS,1972,1975,3,8,1,80,1,36.42,349,73.06,0,3,1,255,1972
AD Poynter,IRE,2008,2014,6,16,0,78,3,19.61,412,61.89,0,2,3,255,2008
N Vanua,PNG,2014,2019,5,20,0,35,3,14.94,289,87.88,0,0,2,254,2014
S Ranatunga,SL,1994,1996,2,11,0,70,0,23.0,526,48.09,0,2,0,253,1994
IP Butchart,ZIM,1983,1995,12,16,0,54,2,18.0,395,63.79,0,1,2,252,1983
NM Coulter-Nile,AUS,2013,2019,6,21,0,92,6,16.8,262,96.18,0,1,2,252,2013
J Edness,BMUDA,2007,2008,1,11,0,72,2,28.0,403,62.53,0,1,1,252,2007
JFM Morrison,NZ,1975,1983,8,15,0,55,3,21.0,472,53.38,0,1,0,252,1975
HA Varaiya,KENYA,2006,2014,8,38,0,34,17,12.0,489,51.53,0,0,3,252,2006
H Klaasen,SA,2018,2019,1,13,0,59,2,22.81,291,86.25,0,1,1,251,2018
JJ Atkinson,HKG,2008,2017,9,9,0,59,0,27.77,398,62.81,0,1,0,250,2008
JAH Marshall,NZ,2005,2008,3,10,0,161,0,25.0,313,79.87,1,1,2,250,2005
CT Radley,ENG,1978,1978,0,4,1,117,1,83.33,367,68.11,1,1,0,250,1978
AR Caddick,ENG,1993,2003,10,38,0,36,18,12.45,395,63.03,0,0,6,249,1993
GF Labrooy,SL,1986,1992,6,36,0,33,7,8.58,350,71.14,0,0,6,249,1986
JD Campbell,WI,2019,2019,0,5,0,179,0,49.6,214,115.88,1,0,0,248,2019
JM Parker,NZ,1974,1981,7,20,0,66,0,12.4,403,61.53,0,1,1,248,1974
RB Reid,NZ,1988,1991,3,9,0,64,0,27.55,448,55.35,0,2,0,248,1988
RH Vance,NZ,1988,1989,1,8,0,96,0,31.0,481,51.55,0,1,0,248,1988
MA Suji,KENYA,1996,2006,10,52,1,16,22,8.23,526,46.95,0,0,9,247,1996
A Turner,AUS,1975,1975,0,6,0,101,0,41.16,309,79.93,1,0,0,247,1975
K Doriga,PNG,2017,2019,2,13,1,89,2,22.36,388,63.4,0,1,1,246,2017
AD Mascarenhas,ENG,2007,2009,2,13,0,52,2,22.27,257,95.33,0,1,2,245,2007
SM Davies,ENG,2009,2011,2,8,0,87,0,30.5,231,105.62,0,1,1,244,2009
JP Kotze,NAM,2019,2019,0,5,0,136,0,48.8,267,91.38,1,0,0,244,2019
RAS Lakmal,SL,2009,2019,10,48,0,26,22,9.38,404,60.39,0,0,9,244,2009
Qaiser Ali,CAN,2006,2008,2,17,0,70,1,15.25,383,63.7,0,2,3,244,2006
RP Burl,ZIM,2017,2019,2,15,0,53,3,20.25,357,68.06,0,1,1,243,2017
BP Patel,INDIA,1974,1979,5,9,0,82,1,30.37,399,60.9,0,1,0,243,1974
PR Downton,ENG,1977,1988,11,20,1,44,5,16.13,358,67.59,0,0,2,242,1977
Hasan Raza,PAK,1996,1999,3,13,0,77,0,18.61,480,50.41,0,1,1,242,1996
MJ Di Venuto,AUS,1997,1997,0,9,0,89,0,26.77,281,85.76,0,2,0,241,1997
GD Drummond,SCOT,2007,2013,6,20,1,35,7,18.46,262,91.6,0,0,2,240,2007
DK Lillee,AUS,1972,1983,11,34,1,42,8,9.23,320,75.0,0,0,6,240,1972
CM Wright,SCOT,2006,2009,3,18,0,37,3,16.0,351,68.37,0,0,2,240,2006
Amjad Javed,UAE,2008,2017,9,13,0,56,1,19.91,267,89.51,0,1,1,239,2008
CRD Fernando,SL,2001,2012,11,61,0,20,35,9.19,392,60.96,0,0,9,239,2001
J Garner,WI,1977,1987,10,41,0,37,15,9.19,360,66.38,0,0,5,239,1977
T Panyangara,ZIM,2004,2016,12,49,0,33,13,6.63,463,51.61,0,0,9,239,2004
KJ Arnott,ZIM,1987,1993,6,12,0,60,2,23.8,491,48.47,0,3,0,238,1987
DC Thomas,WI,2009,2013,4,19,0,37,2,14.0,364,65.38,0,0,3,238,2009
NS Poonia,SCOT,2006,2009,3,21,0,67,0,11.28,377,62.86,0,1,7,237,2006
Enamul Haque,BDESH,1990,2002,12,26,0,32,5,11.23,479,49.26,0,0,1,236,1990
GJ Hopkins,NZ,2004,2010,6,17,0,45,1,14.75,311,75.88,0,0,3,236,2004
LM Jongwe,ZIM,2014,2016,2,19,0,46,3,14.75,303,77.88,0,0,2,236,2014
Khurram Manzoor,PAK,2008,2009,1,7,0,83,0,33.71,375,62.93,0,3,1,236,2008
GR Codrington,CAN,2006,2007,1,15,1,45,3,19.58,372,63.17,0,0,1,235,2006
JP Crawley,ENG,1994,1999,5,12,0,73,1,21.36,408,57.59,0,2,2,235,1994
P Khadka,NEPAL,2018,2019,1,6,0,115,0,39.16,286,82.16,1,1,0,235,2018
PJ Cummins,AUS,2011,2019,8,35,0,36,12,10.17,328,71.34,0,0,5,234,2011
Iftikhar Anjum,PAK,2004,2010,6,34,0,32,19,15.6,378,61.9,0,0,4,234,2004
Ikram Alikhil,AFG,2019,2019,0,12,0,86,3,26.0,386,60.62,0,2,0,234,2019
P Mustard,ENG,2007,2008,1,10,0,83,0,23.3,252,92.46,0,1,0,233,2007
AME Roberts,WI,1975,1983,8,32,1,37,9,10.04,357,64.7,0,0,3,231,1975
STR Binny,INDIA,2014,2015,1,11,0,77,3,28.75,246,93.49,0,1,1,230,2014
TM Chappell,AUS,1980,1983,3,13,0,110,0,17.61,365,62.73,1,0,2,229,1980
SHU Karnain,SL,1984,1990,6,17,1,41,5,19.08,386,59.32,0,0,2,229,1984
TM Dowlin,WI,2009,2010,1,11,1,100,2,25.33,348,65.51,1,1,2,228,2009
DR Flynn,NZ,2008,2012,4,17,0,35,2,15.2,360,63.33,0,0,3,228,2008
AY Karim,KENYA,1996,2003,7,24,0,53,6,12.66,375,60.8,0,1,5,228,1996
SR Thompson,IRE,2013,2017,4,15,0,39,1,16.28,251,90.83,0,0,0,228,2013
M Dillon,WI,1997,2005,8,51,1,21,20,7.32,411,55.23,0,0,9,227,1997
AMJ Hilditch,AUS,1979,1985,6,8,0,72,0,28.25,476,47.47,0,1,0,226,1979
Raza-ur-Rehman,CAN,2013,2014,1,5,0,88,0,45.0,262,85.87,0,3,1,225,2013
BP Julian,AUS,1993,1999,6,17,0,35,0,13.17,250,89.6,0,0,4,224,1993
KR Stackpole,AUS,1971,1974,3,6,0,61,0,37.33,387,57.88,0,3,0,224,1971
JH Edrich,ENG,1971,1975,4,6,0,90,0,37.16,325,68.61,0,2,0,223,1971
V Shankar,INDIA,2019,2019,0,8,0,46,1,31.85,246,90.65,0,0,0,223,2019
KM Jarvis,ZIM,2009,2019,10,33,0,37,10,9.65,337,65.87,0,0,4,222,2009
Aqib Ilyas,OMAN,2019,2019,0,5,0,63,0,44.2,282,78.36,0,2,0,221,2019
BKV Prasad,INDIA,1994,2001,7,63,0,19,31,6.9,367,60.21,0,0,8,221,1994
Sarfraz Nawaz,PAK,1973,1984,11,31,1,34,8,9.6,345,64.05,0,0,5,221,1973
Wasim Bari,PAK,1973,1984,11,26,0,34,13,17.0,431,51.27,0,0,0,221,1973
HS Baidwan,CAN,2008,2014,6,22,0,33,7,14.66,339,64.89,0,0,3,220,2008
DR Lockhart,SCOT,2006,2010,4,11,0,46,2,24.22,341,63.92,0,0,1,218,2006
Y Venugopal Rao,INDIA,2005,2006,1,11,1,61,2,24.22,363,60.05,0,1,2,218,2005
NR Kumar,CAN,2010,2014,4,15,0,38,1,15.5,397,54.65,0,0,1,217,2010
FA Rose,WI,1997,2000,3,23,0,30,5,12.05,265,81.88,0,0,2,217,1997
EO Simons,SA,1994,1995,1,18,0,24,4,15.5,295,73.55,0,0,1,217,1994
V Dahiya,INDIA,2000,2001,1,15,0,51,2,16.61,267,80.89,0,1,2,216,2000
WK Lees,NZ,1979,1983,4,24,0,26,5,11.31,307,70.03,0,0,1,215,1979
NO Perry,WI,1999,2000,1,16,1,52,8,26.5,340,62.35,0,1,2,212,1999
FRJ Coleman,SCOT,2013,2015,2,14,0,70,0,15.07,344,61.33,0,1,2,211,2013
MJ Henry,NZ,2014,2019,5,21,1,48,7,15.07,211,100.0,0,0,3,211,2014
KS Lokuarachchi,SL,2003,2007,4,18,0,69,3,14.0,262,80.15,0,1,2,210,2003
CPH Ramanayake,SL,1986,1995,9,35,0,26,14,10.0,374,56.14,0,0,7,210,1986
Tahir Naqqash,PAK,1980,1985,5,23,0,61,9,15.0,242,86.77,0,1,4,210,1980
Mushtaq Mohammad,PAK,1973,1978,5,9,0,55,3,34.83,353,59.2,0,1,0,209,1973
MHW Papps,NZ,2004,2005,1,6,1,92,2,51.75,342,60.52,0,2,0,207,2004
DL Bairstow,ENG,1979,1984,5,20,1,23,6,14.71,390,52.82,0,0,1,206,1979
AR Berenger,UAE,2014,2015,1,10,0,66,0,20.5,304,67.43,0,2,0,205,2014
PE McEwan,NZ,1980,1985,5,15,0,41,0,13.6,346,58.95,0,0,0,204,1980
JA Rennie,ZIM,1993,2000,7,27,0,27,12,13.4,391,51.4,0,0,6,201,1993
APE Knott,ENG,1971,1977,6,14,0,50,4,20.0,247,80.97,0,1,2,200,1971
NW Bracken,AUS,2001,2009,8,35,1,21,18,11.7,282,70.56,0,0,5,199,2001
AJ Burger,NAM,2003,2003,0,6,0,85,0,33.16,198,100.5,0,1,0,199,2003
Mohammad Nawaz,3) ,2016,2019,3,12,0,53,3,22.11,213,93.42,0,1,0,199,2016
Moin-ul-Atiq,PAK,1988,1989,1,5,0,105,0,39.8,279,71.32,1,0,0,199,1988
M Ntini,SA,1998,2009,11,47,1,42,24,8.65,298,66.77,0,0,9,199,1998
Ijaz Faqih,PAK,1980,1988,8,19,1,42,3,12.31,351,56.12,0,0,4,197,1980
GA Lamb,ZIM,2010,2011,1,14,0,37,3,17.9,381,51.7,0,0,1,197,2010
MR Swart,NL,2011,2014,3,11,0,52,1,19.7,272,72.42,0,1,1,197,2011
T Maruma,ZIM,2007,2019,12,18,0,35,1,11.52,330,59.39,0,0,1,196,2007
AP Devcich,NZ,2013,2016,3,11,0,58,0,17.72,253,77.07,0,1,2,195,2013
GSNFG Jayasuriya,SL,2015,2019,4,10,0,96,1,21.66,273,71.42,0,1,2,195,2015
ASA Perera,SL,1998,2001,3,13,1,56,2,17.72,257,75.87,0,1,1,195,1998
Akram Raza,PAK,1989,1995,6,25,1,33,14,17.54,310,62.25,0,0,4,193,1989
PJ Ingram,NZ,2010,2010,0,7,0,69,0,27.57,238,81.09,0,1,0,193,2010
C Pringle,NZ,1990,1995,5,41,1,34,19,8.77,256,75.39,0,0,3,193,1990
V Rathour,INDIA,1996,1997,1,7,0,54,0,27.57,331,58.3,0,2,0,193,1996
Simi Singh,IRE,2017,2019,2,14,0,45,1,14.84,332,58.13,0,0,1,193,2017
MM Iqbal,SCOT,2009,2014,5,12,0,63,4,24.0,360,53.33,0,1,2,192,2009
CJ Smith,BMUDA,2006,2007,1,12,0,52,0,16.0,245,78.36,0,1,3,192,2006
Abid Ali,PAK,2019,2019,0,4,0,112,0,47.75,196,97.44,1,1,1,191,2019
DAG Fletcher,ZIM,1983,1983,0,6,1,71,2,47.75,289,66.08,0,2,0,191,1983
TN Madondo,ZIM,1998,2001,3,13,0,71,1,15.91,331,57.7,0,1,2,191,1998
Mohammad Boota,UAE,2018,2019,1,9,1,59,1,23.87,252,75.79,0,1,0,191,2018
Shabir Noori,AFG,2010,2016,6,10,0,94,0,19.1,300,63.66,0,1,2,191,2010
CJ McKay,AUS,2009,2014,5,31,0,30,10,9.04,337,56.37,0,0,3,190,2009
Mohammad Shahzad,UAE,2014,2016,2,6,0,79,0,31.66,225,84.44,0,2,2,190,2014
Usman Limbada,CAN,2010,2014,4,11,0,50,1,18.9,284,66.54,0,1,1,189,2010
BAW Mendis,SL,2008,2015,7,42,1,21,19,8.17,263,71.48,0,0,10,188,2008
TJ Murtagh,IRE,2012,2019,7,36,1,23,12,7.83,298,63.08,0,0,7,188,2012
T Mupariwa,ZIM,2004,2016,12,32,0,33,10,8.4,325,56.92,0,0,9,185,2004
SW Poynter,IRE,2014,2019,5,19,0,36,5,13.21,278,66.54,0,0,2,185,2014
EAE Baptiste,WI,1983,1990,7,16,0,31,4,15.33,241,76.34,0,0,0,184,1983
JL Ontong,SA,2001,2012,11,16,0,32,2,13.14,267,68.91,0,0,1,184,2001
Saadat Ali,PAK,1984,1984,0,7,1,78,1,30.66,341,53.95,0,1,0,184,1984
Sohag Gazi,BDESH,2012,2014,2,16,0,30,4,15.33,213,86.38,0,0,0,184,2012
SI de Saram,SL,1999,2001,2,13,0,38,2,16.63,270,67.77,0,0,0,183,1999
SJ Benn,WI,2008,2016,8,30,0,31,7,7.91,240,75.83,0,0,5,182,2008
SR Taylor,USA,2019,2019,0,9,0,56,0,20.22,265,68.67,0,1,2,182,2019
AR Patel,INDIA,2014,2017,3,20,0,38,6,12.92,190,95.26,0,0,3,181,2014
JR Thomson,AUS,1975,1985,10,30,0,21,6,7.54,280,64.64,0,0,5,181,1975
SB Bangar,INDIA,2002,2004,2,15,1,57,2,13.84,239,75.31,0,1,3,180,2002
DG Cork,ENG,1992,2002,10,21,1,31,3,10.0,271,66.42,0,0,4,180,1992
WF Stelling,NL,2006,2007,1,11,0,44,5,30.0,272,66.17,0,0,1,180,2006
B Warnapura,SL,1975,1982,7,12,0,77,0,15.0,415,43.37,0,1,1,180,1975
Mazhar Hussain,UAE,1994,1996,2,7,0,70,0,25.57,334,53.59,0,1,0,179,1994
DM Richards,WI,2009,2010,1,7,0,59,0,25.57,251,71.31,0,2,0,179,2009
TK Curran,ENG,2017,2019,2,11,1,47,7,44.5,166,107.22,0,0,2,178,2017
SC Khanna,INDIA,1979,1984,5,10,0,56,2,22.0,265,66.41,0,2,1,176,1979
TC Bastiampillai,CAN,2007,2014,7,13,0,49,0,13.46,301,58.13,0,0,2,175,2007
BR Blair,NZ,1982,1986,4,14,1,29,2,14.5,253,68.77,0,0,2,174,1982
GC Dyer,AUS,1986,1988,2,13,1,45,2,15.81,227,76.65,0,0,1,174,1986
MD Moxon,ENG,1985,1988,3,8,0,70,0,21.75,325,53.53,0,1,1,174,1985
GRJ Roope,ENG,1973,1978,5,8,0,44,0,21.62,342,50.58,0,0,1,173,1973
SB Doull,NZ,1992,2000,8,27,0,22,13,12.28,188,91.48,0,0,2,172,1992
Hasibul Hossain,BDESH,1995,2004,9,26,1,21,6,8.6,247,69.63,0,0,3,172,1995
BN Cooper,NL,2013,2019,6,6,0,74,0,28.5,184,92.93,0,1,0,171,2013
RP Lefebvre,NL,1996,2003,7,11,0,45,5,28.5,280,61.07,0,0,0,171,1996
DK Morrison,NZ,1987,1996,9,43,1,20,24,9.0,400,42.75,0,0,7,171,1987
I Udana,SL,2012,2019,7,12,0,78,2,17.1,181,94.47,0,1,1,171,2012
D Bau,PNG,2016,2017,1,10,0,46,1,18.88,319,53.29,0,0,2,170,2016
PS de Villiers,SA,1992,1997,5,36,1,20,15,8.09,218,77.98,0,0,7,170,1992
SW Masakadza,ZIM,2010,2014,4,11,1,45,3,21.25,177,96.04,0,0,1,170,2010
CJ Jordan,ENG,2013,2016,3,21,1,38,7,12.07,188,89.89,0,0,3,169,2013
J Smits,NL,2003,2009,6,19,1,29,9,16.9,360,46.94,0,0,2,169,2003
RA Jones,NZ,2003,2003,0,5,0,63,0,33.6,329,51.06,0,1,0,168,2003
AF Milne,NZ,2012,2017,5,17,0,36,7,16.8,165,101.81,0,0,2,168,2012
CP Rizwan,UAE,2019,2019,0,6,0,47,0,28.0,325,51.69,0,0,1,168,2019
AR Whittall,ZIM,1996,2000,4,35,0,29,13,7.63,310,54.19,0,0,6,168,1996
RS Gabriel,WI,1984,1984,0,11,0,41,0,15.18,360,46.38,0,0,2,167,1984
JE Morris,ENG,1990,1991,1,8,1,63,1,23.85,225,74.22,0,1,0,167,1990
Haroon Rasheed,PAK,1977,1982,5,10,1,63,2,20.75,316,52.53,0,1,0,166,1977
A McGrath,ENG,2003,2004,1,12,0,52,2,16.6,353,47.02,0,1,1,166,2003
DES Maxwell,CAN,2006,2007,1,10,0,59,4,27.66,238,69.74,0,1,1,166,2006
TL Chatara,ZIM,2013,2019,6,45,0,23,20,6.6,336,49.1,0,0,8,165,2013
Khurram Chohan,CAN,2009,2014,5,19,1,35,6,12.69,285,57.89,0,0,2,165,2009
JF Kloppenburg,NL,2002,2003,1,6,0,121,0,27.5,265,62.26,1,0,1,165,2002
MJ Lumb,ENG,2014,2014,0,3,0,106,0,55.0,203,81.28,1,0,0,165,2014
JA McCollum,IRE,2019,2019,0,8,0,73,0,20.62,240,68.75,0,2,1,165,2019
GAHM Parkar,INDIA,1982,1984,2,10,0,42,1,18.33,332,49.69,0,0,0,165,1982
D Bishoo,WI,2011,2019,8,25,1,29,10,10.93,263,62.35,0,0,8,164,2011
RB Kanhai,WI,1973,1975,2,5,0,55,2,54.66,273,60.07,0,2,0,164,1973
RR Powar,INDIA,2004,2007,3,19,0,54,5,11.64,260,62.69,0,1,0,163,2004
JC Tredwell,ENG,2010,2015,5,25,0,30,11,11.64,242,67.35,0,0,3,163,2010
Faheem Ashraf,PAK,2017,2019,2,15,0,28,2,12.46,195,83.07,0,0,2,162,2017
MV Nagamootoo,WI,2000,2002,2,18,0,33,6,13.5,270,60.0,0,0,1,162,2000
JTC Vaughan,NZ,1992,1996,4,16,0,33,7,18.0,261,62.06,0,0,0,162,1992
T Bavuma,SA,2016,2017,1,2,0,113,0,80.5,170,94.7,1,0,0,161,2016
CD Cumming,NZ,2003,2009,6,13,1,45,1,13.41,301,53.48,0,0,3,161,2003
SKL de Silva,SL,1997,1997,0,6,0,57,3,53.66,193,83.41,0,2,0,161,1997
SC Joseph,WI,2000,2005,5,11,0,58,1,16.1,302,53.31,0,1,2,161,2000
KMA Paul,WI,2018,2019,1,11,0,46,3,20.12,194,82.98,0,0,1,161,2018
E Schiferli,NL,2002,2013,11,22,0,41,6,10.06,218,73.85,0,0,4,161,2002
HMCM Bandara,SL,2006,2010,4,17,0,31,4,12.3,224,71.42,0,0,3,160,2006
PE Cantrell,NL,1996,1996,0,5,0,47,0,32.0,307,52.11,0,0,0,160,1996
MS Chapman,HKG/NZ,2015,2018,3,5,1,124,1,40.0,174,91.95,1,0,1,160,2015
JL Langer,AUS,1994,1997,3,7,0,36,2,32.0,180,88.88,0,0,0,160,1994
K Weeraratne,SL,2000,2008,8,9,0,41,1,20.0,177,90.39,0,0,0,160,2000
Saleem Raza,UAE,1994,1996,2,6,0,84,0,26.5,173,91.9,0,1,0,159,1994
AC Bedade,INDIA,1994,1994,0,10,0,51,3,22.57,183,86.33,0,1,0,158,1994
DAJ Bracewell,NZ,2011,2019,8,12,0,57,2,15.8,214,73.83,0,1,1,158,2011
JJ Martin,INDIA,1999,2001,2,8,0,39,1,22.57,331,47.73,0,0,1,158,1999
Imran Tahir,SA,2011,2019,8,36,0,29,16,7.85,225,69.77,0,0,6,157,2011
MP Maynard,ENG,1994,2000,6,12,0,41,1,14.18,225,69.33,0,0,1,156,1994
IJ Gould,ENG,1983,1983,0,14,0,42,2,12.91,243,63.78,0,0,2,155,1983
PM Seelaar,NL,2006,2019,13,24,1,34,10,11.07,244,63.52,0,0,5,155,2006
TA Boult,NZ,2012,2019,7,39,1,21,23,9.62,209,73.68,0,0,1,154,2012
GJ Cosier,AUS,1975,1979,4,7,0,84,2,30.8,166,92.77,0,1,1,154,1975
AM Ellis,NZ,2012,2013,1,12,0,33,1,14.0,184,83.69,0,0,1,154,2012
Mohammad Hussain,PAK,1997,1998,1,12,1,31,7,30.8,136,113.23,0,0,0,154,1997
CJ Richards,ENG,1981,1988,7,16,0,50,3,11.84,264,58.33,0,1,3,154,1981
RML Taylor,SCOT,2013,2016,3,14,1,46,3,14.0,172,89.53,0,0,1,154,2013
C Zhuwao,ZIM,2008,2018,10,9,0,45,0,17.11,132,116.66,0,0,3,154,2008
CPS Chauhan,INDIA,1978,1981,3,7,0,46,0,21.85,301,50.83,0,0,0,153,1978
AN Ranasinghe,SL,1975,1982,7,8,0,51,1,21.85,147,104.08,0,1,2,153,1975
DW Fleming,AUS,1994,2001,7,31,0,29,18,11.69,221,68.77,0,0,5,152,1994
MDK Perera,SL,2007,2018,11,12,0,30,0,12.66,199,76.38,0,0,0,152,2007
AJ Redmond,NZ,2009,2010,1,6,0,52,0,25.33,259,58.68,0,1,0,152,2009
MW Alleyne,ENG,1999,2000,1,8,0,53,1,21.57,255,59.21,0,1,0,151,1999
J Anderson,IRE,2014,2016,2,8,0,39,0,18.87,267,56.55,0,0,0,151,2014
RS Gavaskar,INDIA,2004,2004,0,10,0,54,2,18.87,234,64.52,0,1,0,151,2004
BF Hastings,NZ,1973,1975,2,9,0,37,1,18.87,271,55.71,0,0,1,151,1973
VD Philander,SA,2007,2015,8,19,1,30,7,12.58,213,70.89,0,0,3,151,2007
RG Aga,KENYA,2004,2014,10,9,0,86,0,16.66,209,71.77,0,1,1,150,2004
BB Chari,ZIM,2015,2019,4,11,0,39,0,13.63,332,45.18,0,0,0,150,2015
NA Foster,ENG,1984,1989,5,25,0,24,12,11.53,244,61.47,0,0,3,150,1984
GD Barlow,ENG,1976,1977,1,6,1,80,1,29.8,255,58.43,0,1,2,149,1976
AR Khurasiya,INDIA,1999,2001,2,11,0,57,0,13.54,188,79.25,0,1,1,149,1999
Khalid Latif,PAK,2008,2010,2,5,0,64,0,29.4,228,64.47,0,1,1,147,2008
Nazimuddin,BDESH,2008,2012,4,11,0,47,0,13.36,237,62.02,0,0,0,147,2008
GM Strydom,ZIM,2006,2006,0,10,0,58,0,14.7,225,65.33,0,1,2,147,2006
MRJ Watt,SCOT,2016,2019,3,17,1,31,7,14.7,202,72.77,0,0,0,147,2016
D Williams,WI,1988,1997,9,23,1,32,7,9.18,242,60.74,0,0,4,147,1988
JA Burns,AUS,2015,2015,0,6,0,69,0,24.33,184,79.34,0,1,1,146,2015
SE Findlay,WI,2008,2009,1,8,1,59,1,20.85,194,75.25,0,1,0,146,2008
Sompal Kami,NEPAL,2018,2019,1,6,0,61,2,36.5,164,89.02,0,1,1,146,2018
MP O'Dowd,NL,2019,2019,0,2,1,86,1,145.0,200,72.5,0,2,0,145,2019
AC Agar,AUS,2015,2018,3,8,0,46,1,20.57,166,86.74,0,0,2,144,2015
R Clarke,ENG,2003,2006,3,13,0,39,0,11.07,232,62.06,0,0,2,144,2003
DK Liyanage,SL,1992,2001,9,11,0,43,2,16.0,207,69.56,0,0,0,144,1992
LN Onyango,KENYA,1996,2014,18,18,1,34,7,13.09,188,76.59,0,0,2,144,1996
G Malla,NEPAL,2018,2019,1,6,0,51,0,23.83,189,75.66,0,1,1,143,2018
Abdur Rehman,PAK,2006,2014,8,23,0,31,6,8.35,263,53.99,0,0,4,142,2006
CM Kuggeleijn,NZ,1988,1989,1,11,0,40,2,15.77,223,63.67,0,0,1,142,1988
D Langford-Smith,IRE,2006,2008,2,17,1,31,8,15.77,133,106.76,0,0,2,142,2006
MB Loye,ENG,2007,2007,0,7,0,45,0,20.28,184,77.17,0,0,1,142,2007
K Zondo,SA,2018,2018,0,5,0,54,1,35.5,224,63.39,0,1,0,142,2018
DE Bernard,WI,2003,2010,7,12,0,38,2,14.1,219,64.38,0,0,1,141,2003
ARC Fraser,ENG,1989,1999,10,20,1,38,9,12.81,208,67.78,0,0,1,141,1989
OD Gibson,WI,1995,1997,2,11,0,52,1,14.1,138,102.17,0,1,1,141,1995
CR Matthews,SA,1991,1997,6,22,0,26,9,10.84,202,69.8,0,0,3,141,1991
A Nehra,INDIA,2001,2011,10,46,0,24,21,5.64,246,57.31,0,0,9,141,2001
Shahid Saeed,PAK,1989,1993,4,10,0,50,0,14.1,316,44.62,0,1,0,141,1989
VJ Wells,ENG,1999,1999,0,7,0,39,0,20.14,253,55.73,0,0,0,141,1999
AF Buurman,NL,2007,2011,4,11,0,34,2,15.55,179,78.21,0,0,2,140,2007
HMRKB Herath,SL,2004,2015,11,30,1,17,15,9.33,217,64.51,0,0,3,140,2004
Rubel Hossain,BDESH,2009,2019,10,52,0,17,24,5.0,249,56.22,0,0,11,140,2009
JM Wiener,AUS,1979,1980,1,7,0,50,0,20.0,324,43.2,0,1,0,140,1979
MV Fleming,ENG,1997,1998,1,10,0,33,1,15.44,137,101.45,0,0,1,139,1997
KH MacLeay,AUS,1983,1987,4,13,0,41,2,12.63,170,81.76,0,0,0,139,1983
EAR de Silva,SL,1986,1992,6,20,1,19,6,9.85,241,57.26,0,0,2,138,1986
GN Edwards,NZ,1976,1981,5,6,0,41,0,23.0,191,72.25,0,0,1,138,1976
KA Hope,WI,2017,2017,0,6,0,46,0,23.0,192,71.87,0,0,0,138,2017
S Samarawickrama,SL,2017,2019,2,7,0,54,0,19.71,165,83.63,0,1,2,138,2017
RJ Bailey,ENG,1985,1990,5,4,1,43,2,68.5,196,69.89,0,0,0,137,1985
RM Hogg,AUS,1979,1985,6,35,0,22,20,9.13,217,63.13,0,0,2,137,1979
APB Tennekoon,SL,1975,1979,4,4,0,59,0,34.25,207,66.18,0,1,1,137,1975
ST Finn,ENG,2011,2017,6,30,0,35,13,8.0,223,60.98,0,0,7,136,2011
G Miller,ENG,1977,1984,7,18,0,46,2,8.5,265,51.32,0,0,3,136,1977
Mohammed Shami,INDIA,2013,2019,6,34,0,25,16,7.55,164,82.92,0,0,5,136,2013
LG Rowe,WI,1975,1980,5,8,0,60,0,17.0,244,55.73,0,1,0,136,1975
KD Shah,HKG,2014,2018,4,10,1,34,1,15.11,238,57.14,0,0,2,136,2014
R Vijay Bharadwaj,INDIA,1999,2002,3,9,1,41,4,27.2,194,70.1,0,0,1,136,1999
SRD Wettimuny,SL,1975,1979,4,3,0,67,1,68.0,242,56.19,0,2,0,136,1975
D Pretorius,SA,2016,2019,3,10,0,50,1,15.0,145,93.1,0,1,1,135,2016
PA Browne,WI,2008,2008,0,5,1,49,1,33.5,179,74.86,0,0,0,134,2008
TS Chisoro,ZIM,2015,2018,3,15,1,42,6,14.88,218,61.46,0,0,2,134,2015
Krishna Chandran,UAE,2014,2016,2,10,0,43,2,16.75,274,48.9,0,0,3,134,2014
Arshad Khan,PAK,1993,2006,13,29,0,20,18,12.09,217,61.29,0,0,5,133,1993
MD Bell,NZ,1998,2001,3,7,0,66,0,19.0,268,49.62,0,1,0,133,1998
RJ Sidebottom,ENG,2001,2010,9,18,0,24,8,13.3,194,68.55,0,0,2,133,2001
RK Chauhan,INDIA,1993,1997,4,18,0,32,5,10.15,171,77.19,0,0,4,132,1993
D Keulder,NAM,2003,2003,0,6,0,52,0,22.0,220,60.0,0,1,1,132,2003
Bazid Khan,PAK,2004,2008,4,5,0,66,0,26.2,232,56.46,0,2,1,131,2004
MSK Prasad,INDIA,1998,1999,1,11,0,63,2,14.55,225,58.22,0,1,2,131,1998
Sajid Ali,PAK,1984,1997,13,12,0,28,0,10.83,293,44.36,0,0,0,130,1984
RW Taylor,ENG,1973,1984,11,17,1,26,7,13.0,312,41.66,0,0,2,130,1973
RJ Trott,BMUDA,2007,2009,2,10,1,48,4,21.66,249,52.2,0,0,1,130,2007
TJ Zoehrer,AUS,1986,1994,8,15,0,50,3,10.83,183,71.03,0,1,2,130,1986
KTGD Prasad,SL,2006,2015,9,12,1,31,6,21.5,146,88.35,0,0,1,129,2006
Shafiul Islam,BDESH,2010,2019,9,33,1,24,11,5.86,235,54.89,0,0,9,129,2010
BOP Fernando,SL,2019,2019,0,6,0,49,0,21.33,203,63.05,0,0,1,128,2019
FC Hayes,ENG,1973,1975,2,6,0,52,1,25.6,235,54.46,0,1,0,128,1973
Khawar Ali,OMAN,2019,2019,0,5,1,79,1,32.0,256,50.0,0,1,0,128,2019
DT Hondo,ZIM,2001,2005,4,29,0,17,12,7.47,249,51.0,0,0,4,127,2001
TE Jesty,ENG,1983,1983,0,10,1,52,4,21.16,182,69.78,0,1,2,127,1983
A Nel,SA,2001,2008,7,22,1,30,12,12.7,166,76.5,0,0,2,127,2001
Yasir Shah,PAK,2011,2019,8,13,1,32,6,18.14,149,85.23,0,0,2,127,2011
SJ Baard,NAM,2019,2019,0,5,0,73,0,25.2,199,63.31,0,1,1,126,2019
Basil Hameed,UAE,2019,2019,0,3,1,63,1,63.0,177,71.18,0,1,0,126,2019
Dhiman Ghosh,BDESH,2008,2008,0,12,0,30,3,14.0,201,62.68,0,0,3,126,2008
MG Erasmus,NAM,2019,2019,0,5,0,88,0,25.2,169,74.55,0,1,1,126,2019
M Kartik,INDIA,2002,2007,5,14,1,32,5,14.0,178,70.78,0,0,1,126,2002
TRO Payne,WI,1984,1987,3,4,0,60,0,31.5,240,52.5,0,1,0,126,1984
CP Senanayake,SL,1990,1991,1,7,0,27,0,18.0,211,59.71,0,0,1,126,1990
PA Jaques,AUS,2006,2007,1,6,0,94,0,20.83,176,71.02,0,1,1,125,2006
MC Sorensen,IRE,2013,2016,3,8,0,31,2,20.83,155,80.64,0,0,0,125,2013
AJ Turner,AUS,2019,2019,0,3,1,84,1,62.5,86,145.34,0,1,0,125,2019
AIC Dodemaide,AUS,1988,1993,5,16,0,30,7,13.77,159,77.98,0,0,1,124,1988
ZE Green,NAM,2019,2019,0,5,0,41,0,24.8,182,68.13,0,0,0,124,2019
A Maregwede,ZIM,2003,2005,2,11,0,37,1,12.4,218,56.88,0,0,1,124,2003
JA Samarasekera,UAE,1994,1996,2,6,1,47,2,31.0,215,57.67,0,0,0,124,1994
M van Jaarsveld,SA,2002,2004,2,7,0,45,1,20.66,169,73.37,0,0,1,124,2002
LR Williams,WI,1996,2001,5,13,0,41,2,11.27,186,66.66,0,0,2,124,1996
Ziaur Rahman,BDESH,2013,2014,1,11,0,41,0,11.27,110,112.72,0,0,3,124,2013
CD de Lange,SCOT,2016,2017,1,10,1,26,4,20.5,200,61.5,0,0,0,123,2016
BM Duckett,ENG,2016,2016,0,3,0,63,0,41.0,152,80.92,0,2,1,123,2016
GA Paterson,ZIM,1983,1987,4,10,0,27,0,12.3,327,37.61,0,0,1,123,1983
J Arun Lal,INDIA,1982,1989,7,13,0,51,0,9.38,232,52.58,0,1,4,122,1982
RL Bhudia,KENYA,2008,2009,1,5,0,47,0,24.4,124,98.38,0,0,0,122,2008
CRM Douglas,BMUDA,2008,2008,0,2,0,69,0,61.0,218,55.96,0,2,0,122,2008
BA Parchment,WI,2007,2008,1,7,0,48,0,17.42,217,56.22,0,0,0,122,2007
SK Gupta,KENYA,1996,2001,5,10,0,41,1,13.44,220,55.0,0,0,3,121,1996
GJAF Aponso,NL,1996,1996,0,4,0,58,0,30.0,247,48.58,0,1,0,120,1996
L Balaji,INDIA,2002,2009,7,16,1,21,6,12.0,152,78.94,0,0,2,120,2002
Shahid Mahboob,PAK,1982,1984,2,6,0,77,1,23.8,194,61.34,0,1,1,119,1982
EJ Chatfield,NZ,1979,1989,10,48,1,19,37,10.72,346,34.1,0,0,6,118,1979
DBL Powell,WI,2002,2009,7,25,1,48,3,5.36,164,71.95,0,0,8,118,2002
JN Snape,ENG,2001,2002,1,7,0,38,3,29.5,173,68.2,0,0,0,118,2001
V Yadav,INDIA,1992,1994,2,12,1,34,2,11.8,116,101.72,0,0,2,118,1992
MR Adair,IRE,2019,2019,0,8,0,32,2,19.5,101,115.84,0,0,0,117,2019
DH Brain,ZIM,1992,1995,3,18,0,27,4,8.35,171,68.42,0,0,2,117,1992
NB Mahwire,ZIM,2004,2006,2,19,1,22,8,10.63,249,46.98,0,0,2,117,2004
FL Reifer,WI,1997,2009,12,8,0,40,0,14.62,229,51.09,0,0,0,117,1997
Arshad Ayub,INDIA,1987,1990,3,17,1,31,7,11.6,162,71.6,0,0,1,116,1987
Azam Khan,PAK,1996,1998,2,5,0,72,0,23.2,177,65.53,0,1,0,116,1996
PH Edmonds,ENG,1977,1987,10,18,0,20,7,10.54,232,50.0,0,0,3,116,1977
Hamza Tariq,CAN,2011,2014,3,7,0,71,0,16.57,157,73.88,0,1,2,116,2011
Tauseef Ahmed,PAK,1982,1990,8,25,1,27,14,10.54,216,53.7,0,0,3,116,1982
PWH de Silva,SL,2017,2019,2,10,0,30,2,14.37,111,103.6,0,0,2,115,2017
GK Khoda,INDIA,1998,1998,0,2,0,89,0,57.5,185,62.16,0,1,0,115,1998
GD McGrath,AUS,1993,2007,14,68,0,11,38,3.83,236,48.72,0,0,14,115,1993
MA Carberry,ENG,2013,2014,1,6,0,63,0,19.0,180,63.33,0,1,0,114,2013
C Carter,HKG,2015,2018,3,9,0,43,0,12.66,186,61.29,0,0,0,114,2015
GR Dilley,ENG,1979,1988,9,18,1,31,8,11.4,133,85.71,0,0,2,114,1979
FM Engineer,INDIA,1974,1975,1,4,1,54,1,38.0,195,58.46,0,1,0,114,1974
KD Ghavri,INDIA,1975,1981,6,16,0,20,6,11.4,194,58.76,0,0,1,114,1975
MO Jones,BMUDA,2006,2007,1,12,0,27,2,11.3,149,75.83,0,0,1,113,2006
DL Maddy,ENG,1998,2000,2,6,0,53,0,18.83,206,54.85,0,1,1,113,1998
Naved Anjum,PAK,1984,1992,8,12,0,30,3,12.55,154,73.37,0,0,1,113,1984
MJ Cosgrove,AUS,2006,2006,0,3,0,74,0,37.33,116,96.55,0,1,0,112,2006
JN Frylinck,NAM,2019,2019,0,5,0,60,2,37.33,97,115.46,0,1,0,112,2019
K Gore,USA,2019,2019,0,7,0,31,2,22.4,171,65.49,0,0,0,112,2019
Haseeb Amjad,HKG,2014,2016,2,6,0,42,1,22.4,85,131.76,0,0,1,112,2014
DP Hyatt,WI,2011,2011,0,9,0,39,1,14.0,188,59.57,0,0,1,112,2011
CT Mutombodzi,ZIM,2013,2015,2,10,0,27,1,12.44,160,70.0,0,0,0,112,2013
Hasan Jamil,PAK,1977,1978,1,5,0,28,0,22.2,120,92.5,0,0,0,111,1977
RDM Leverock,BMUDA,2006,2009,3,19,1,20,9,11.1,382,29.05,0,0,1,111,2006
Shan Masood,PAK,2019,2019,0,5,0,50,0,22.2,145,76.55,0,1,1,111,2019
RD Brown,ZIM,1983,1987,4,7,0,38,0,15.71,334,32.93,0,0,0,110,1983
BJ McCarthy,IRE,2016,2019,3,18,0,18,4,7.85,201,54.72,0,0,2,110,2016
Rashid Khan,PAK,1980,1985,5,15,0,17,7,13.75,173,63.58,0,0,0,110,1980
MG Burmester,ZIM,1992,1995,3,7,0,39,1,18.16,207,52.65,0,0,0,109,1992
CL Smith,ENG,1984,1984,0,4,0,70,0,27.25,240,45.41,0,1,0,109,1984
CG Williams,NAM,2019,2019,0,5,1,36,1,27.25,181,60.22,0,0,0,109,2019
DS Airee,NEPAL,2018,2019,1,6,0,40,0,18.0,158,68.35,0,0,1,108,2018
MJ McClenaghan,NZ,2013,2016,3,14,1,34,10,27.0,138,78.26,0,0,0,108,2013
SS McKechnie,HKG,2017,2018,1,8,0,29,1,15.42,193,55.95,0,0,2,108,2017
R Murray,ZIM,2018,2018,0,5,0,47,1,27.0,178,60.67,0,0,0,108,2018
Hamid Hassan,AFG,2009,2019,10,22,0,17,6,6.68,195,54.87,0,0,4,107,2009
SJ Rhodes,ENG,1989,1995,6,8,0,56,2,17.83,150,71.33,0,1,0,107,1989
G Cook,ENG,1981,1983,2,6,0,32,0,17.66,261,40.61,0,0,0,106,1981
CR Foggo,BMUDA,2008,2008,0,4,0,60,0,26.5,174,60.91,0,1,0,106,2008
KO Meth,ZIM,2006,2012,6,8,0,53,0,13.25,183,57.92,0,1,2,106,2006
Faruk Ahmed,BDESH,1988,1999,11,7,0,57,0,15.0,273,38.46,0,1,1,105,1988
AS Joseph,WI,2016,2019,3,10,1,29,6,26.25,126,83.33,0,0,1,105,2016
RK Kleinveldt,SA,2013,2013,0,7,0,43,0,15.0,124,84.67,0,0,1,105,2013
TJ Laughlin,AUS,1978,1979,1,5,0,74,1,26.25,160,65.62,0,1,0,105,1978
PM Toohey,AUS,1978,1979,1,4,1,54,2,52.5,133,78.94,0,1,0,105,1978
CD Collymore,WI,1999,2007,8,35,1,13,17,5.77,261,39.84,0,0,8,104,1999
D Elgar,SA,2012,2018,6,7,0,42,1,17.33,177,58.75,0,0,0,104,2012
BP Nash,WI,2008,2009,1,7,1,39,3,26.0,141,73.75,0,0,0,104,2008
RP Singh,INDIA,2005,2011,6,20,0,23,10,10.4,242,42.97,0,0,3,104,2005
K Birkenstock,NAM,2019,2019,0,5,0,61,0,20.6,193,53.36,0,1,2,103,2019
MW Priest,NZ,1990,1998,8,14,0,24,4,10.3,225,45.77,0,0,2,103,1990
G Toka,PNG,2019,2019,0,6,0,29,0,17.16,190,54.21,0,0,0,103,2019
JW Wilson,NZ,1993,2005,12,6,1,44,1,20.6,112,91.96,0,0,1,103,1993
Ehsan Khan,HKG,2016,2018,2,12,1,27,3,11.33,228,44.73,0,0,2,102,2016
Waqas Barkat,HKG,2014,2018,4,10,0,27,2,12.75,184,55.43,0,0,3,102,2014
D Wiese,SA,2015,2016,1,6,1,41,1,20.4,115,88.69,0,0,0,102,2015
Arshad Laeeq,UAE,1994,1996,2,6,1,43,1,20.2,215,46.97,0,0,1,101,1994
XJ Doherty,AUS,2010,2015,5,23,1,15,16,14.42,184,54.89,0,0,2,101,2010
ERNS Fernando,SL,1983,1983,0,5,0,36,0,20.2,216,46.75,0,0,2,101,1983
RO Hinds,WI,2001,2004,3,9,1,18,3,16.83,170,59.41,0,0,0,101,2001
WR James,ZIM,1992,1996,4,8,0,29,1,14.42,255,39.6,0,0,1,101,1992
Kuldeep Yadav,INDIA,2017,2019,2,20,0,19,12,12.62,173,58.38,0,0,1,101,2017
TA Lloyd,ENG,1984,1984,0,3,0,49,0,33.66,228,44.29,0,0,0,101,1984
Tabarak Dar,HKG,2004,2008,4,4,0,36,0,25.25,175,57.71,0,0,0,101,2004
GB Troup,NZ,1976,1985,9,12,0,39,8,25.25,140,72.14,0,0,0,101,1976
S Amarnath,INDIA,1978,1978,0,3,0,62,0,33.33,119,84.03,0,1,0,100,1978
S Elworthy,SA,1998,2002,4,16,0,23,8,12.5,160,62.5,0,0,3,100,1998
AC Evans,SCOT,2009,2019,10,18,0,28,8,10.0,157,63.69,0,0,2,100,2009
MG Hughes,AUS,1988,1993,5,17,0,20,8,11.11,134,74.62,0,0,3,100,1988
Shahzaib Hasan,PAK,2010,2010,0,3,0,50,0,33.33,113,88.49,0,1,0,100,2010
NMK Smith,ENG,1996,1996,0,6,0,31,1,20.0,132,75.75,0,0,0,100,1996
A Zampa,AUS,2016,2019,3,20,0,22,5,6.66,159,62.89,0,0,3,100,2016
Akshay Homraj,USA,2019,2019,0,4,0,34,0,24.75,135,73.33,0,0,0,99,2019
LV Garrick,WI,2001,2001,0,3,0,76,0,33.0,204,48.52,0,1,0,99,2001
AFG Griffith,WI,1996,2000,4,8,0,47,1,14.14,177,55.93,0,0,0,99,1996
Irfan Ahmed,HKG,2008,2014,6,6,0,37,0,16.5,125,79.2,0,0,1,99,2008
BC Rose,ENG,1977,1977,0,2,0,54,0,49.5,210,47.14,0,1,0,99,1977
Saad Nasim,PAK,2015,2015,0,3,1,77,1,49.5,124,79.83,0,1,1,99,2015
Sandeep Goud,OMAN,2019,2019,0,4,1,67,1,33.0,112,88.39,0,1,2,99,2019
DCC Borden,BMUDA,2006,2008,2,11,0,24,4,14.0,195,50.25,0,0,2,98,2006
GJ Crocker,ZIM,1992,1993,1,5,0,50,1,24.5,105,93.33,0,1,0,98,1992
EJ Gray,NZ,1984,1988,4,7,0,38,1,16.33,230,42.6,0,0,0,98,1984
LR Johnson,WI,2008,2015,7,6,0,51,0,16.33,175,56.0,0,1,1,98,2008
I Maraj,CAN,2003,2003,0,6,1,53,1,19.6,264,37.12,0,1,2,98,2003
Mohammad Ishaq,UAE,1994,1996,2,5,1,51,1,24.5,130,75.38,0,1,0,98,1994
GC Small,ENG,1987,1992,5,24,1,18,9,6.53,188,52.12,0,0,6,98,1987
Sohrawordi Shuvo,BDESH,2010,2011,1,10,1,20,3,14.0,135,72.59,0,0,0,98,2010
GM Ewing,ZIM,2004,2005,1,7,0,46,0,13.85,137,70.8,0,0,2,97,2004
AL Kandappah,CAN,2007,2007,0,2,1,69,1,97.0,156,62.17,0,1,0,97,2007
RB Kerr,AUS,1985,1985,0,4,1,87,1,32.33,159,61.0,0,1,0,97,1985
Manzoor Akhtar,PAK,1997,1998,1,4,0,44,0,24.25,147,65.98,0,0,0,97,1997
Azhar Hossain,BDESH,1988,1990,2,7,0,54,0,13.71,266,36.09,0,1,0,96,1988
MP Bicknell,ENG,1990,1991,1,6,1,31,2,24.0,104,92.3,0,0,0,96,1990
RE van der Merwe,NL/SA,2009,2019,10,8,0,57,3,19.2,95,101.05,0,1,1,96,2009
Aamer Yamin,PAK,2015,2018,3,3,0,62,2,95.0,96,98.95,0,1,0,95,2015
D Daesrath,CAN,2012,2013,1,3,0,40,0,31.66,137,69.34,0,0,0,95,2012
AA Donald,SA,1991,2003,12,40,0,13,18,4.31,279,34.05,0,0,12,95,1991
Mohammad Tauqir,UAE,2004,2015,11,9,0,55,2,13.57,164,57.92,0,1,0,95,2004
HK Olonga,ZIM,1995,2003,8,27,0,31,14,7.3,163,58.28,0,0,6,95,1995
JS Patel,NZ,2005,2017,12,15,0,34,8,13.57,162,58.64,0,0,1,95,2005
KL Tucker,BMUDA,2006,2007,1,12,0,34,2,9.5,246,38.61,0,0,1,95,2006
Aarif Sheikh,NEPAL,2018,2019,1,6,0,29,1,18.8,176,53.4,0,0,1,94,2018
PC de Silva,SL,2014,2017,3,7,0,44,1,15.66,112,83.92,0,0,0,94,2014
VC Drakes,WI,1995,2004,9,17,0,25,5,7.83,174,54.02,0,0,2,94,1995
GFJ Liebenberg,SA,1995,1998,3,4,0,39,0,23.5,199,47.23,0,0,0,94,1995
Mohammed Qasim,UAE,2017,2017,0,5,0,41,0,18.8,188,50.0,0,0,0,94,2017
LJ Tucker,IRE,2019,2019,0,5,0,56,1,23.5,103,91.26,0,1,1,94,2019
S Abid Ali,INDIA,1974,1975,1,3,0,70,0,31.0,132,70.45,0,1,0,93,1974
Kabir Ali,ENG,2003,2006,3,9,1,39,3,15.5,108,86.11,0,0,2,93,2003
PVD Chameera,SL,2015,2019,4,14,1,19,7,13.28,150,62.0,0,0,1,93,2015
MR Gillespie,NZ,2006,2009,3,14,0,28,8,15.5,118,78.81,0,0,1,93,2006
V Mehra,UAE,1994,1996,2,6,0,43,1,18.4,202,45.54,0,0,0,92,1994
BC Strang,ZIM,1995,2001,6,26,0,18,8,5.11,220,41.81,0,0,5,92,1995
SJ Harmison,ENG,2002,2009,7,25,1,18,14,8.27,141,64.53,0,0,3,91,2002
JV Harris,CAN,2003,2003,0,6,0,31,0,15.16,204,44.6,0,0,0,91,2003
SG Peall,ZIM,1992,1996,4,15,0,21,1,6.5,150,60.66,0,0,4,91,1992
DP Samaraweera,SL,1993,1994,1,4,0,49,0,22.75,169,53.84,0,0,0,91,1993
RT Lyons,SCOT,2006,2010,4,14,0,28,10,22.5,147,61.22,0,0,0,90,2006
GB Murgatroyd,NAM,2003,2003,0,6,0,52,0,15.0,145,62.06,0,1,2,90,2003
A Nao,PNG,2017,2019,2,11,0,46,9,45.0,83,108.43,0,0,0,90,2017
A Ratra,INDIA,2002,2002,0,8,0,30,1,12.85,127,70.86,0,0,0,90,2002
Aamer Hanif,PAK,1993,1995,2,4,1,36,2,44.5,128,69.53,0,0,0,89,1993
FA Allen,WI,2018,2019,1,10,0,51,3,12.71,101,88.11,0,1,1,89,2018
Bilawal Bhatti,PAK,2013,2015,2,7,0,39,1,14.83,75,118.66,0,0,1,89,2013
JJ van der Wath,SA,2006,2007,1,8,1,37,2,14.83,70,127.14,0,0,3,89,2006
VB Chandrasekhar,INDIA,1988,1990,2,7,0,53,0,12.57,162,54.32,0,1,0,88,1988
NK Patel,USA,2019,2019,0,5,0,40,0,17.6,134,65.67,0,0,0,88,2019
Raees Ahmadzai,AFG,2009,2010,1,4,0,39,1,29.33,137,64.23,0,0,0,88,2009
AJ Traicos,ZIM,1983,1993,10,17,0,19,9,11.0,175,50.28,0,0,1,88,1983
Anil Dalpat,PAK,1984,1986,2,10,0,37,3,12.42,136,63.97,0,0,1,87,1984
H Hiri,PNG,2016,2019,3,7,1,31,3,21.75,137,63.5,0,0,1,87,2016
K Jethi,CAN,2008,2008,0,3,1,46,1,43.5,79,110.12,0,0,0,87,2008
Suraj Kumar,OMAN,2019,2019,0,4,1,35,1,29.0,144,60.41,0,0,0,87,2019
RM Ellison,ENG,1984,1986,2,12,0,24,4,10.75,110,78.18,0,0,0,86,1984
BD Julien,WI,1973,1977,4,8,1,26,2,14.33,148,58.1,0,0,1,86,1973
EH Mattis,WI,1981,1981,0,2,0,62,0,43.0,190,45.26,0,1,0,86,1981
AD Mullally,ENG,1996,2001,5,25,0,20,10,5.73,238,36.13,0,0,6,86,1996
RK Paudel,NEPAL,2018,2019,1,4,0,55,0,21.5,111,77.47,0,1,0,86,2018
WB Rankin,ENG/IRE,2007,2019,12,32,1,18,19,6.61,198,43.43,0,0,4,86,2007
R Vinay Kumar,INDIA,2010,2013,3,13,1,27,4,9.55,146,58.9,0,0,2,86,2010
BV Vitori,ZIM,2011,2018,7,14,1,20,3,7.81,90,95.55,0,0,5,86,2011
W Watson,NZ,1986,1994,8,24,0,21,13,7.81,180,47.77,0,0,3,86,1986
PB Dassanayake,SL,1993,1994,1,10,1,20,2,10.62,142,59.85,0,0,0,85,1993
PJC Hoffmann,SCOT,2006,2007,1,14,0,31,3,7.72,69,123.18,0,0,3,85,2006
KAD Hurdle,BMUDA,2006,2007,1,13,0,22,5,10.62,101,84.15,0,0,2,85,2006
SI Mahmood,ENG,2004,2009,5,15,1,22,4,7.72,101,84.15,0,0,3,85,2004
KJ Barnett,ENG,1988,1988,0,1,0,84,0,84.0,146,57.53,0,1,0,84,1988
IG Butler,NZ,2002,2010,8,13,0,25,5,10.5,154,54.54,0,0,2,84,2002
SF Dukanwala,UAE,1996,1996,0,4,1,40,2,42.0,139,60.43,0,0,0,84,1996
VB John,SL,1982,1987,5,19,0,15,10,9.33,152,55.26,0,0,3,84,1982
GI Maiden,SCOT,2010,2011,1,6,0,31,2,21.0,133,63.15,0,0,1,84,2010
Saqib Ali,UAE,2008,2014,6,5,1,25,1,21.0,129,65.11,0,0,0,84,2008
Younis Ahmed,PAK,1987,1987,0,2,0,58,0,42.0,151,55.62,0,1,0,84,1987
OAC Banks,WI,2003,2005,2,5,0,33,0,16.6,149,55.7,0,0,0,83,2003
GH Bodi,SA,2007,2007,0,2,0,51,0,41.5,132,62.87,0,1,0,83,2007
AG Davies,SCOT,1999,1999,0,5,0,32,1,20.75,154,53.89,0,0,1,83,1999
LHD Dilhara,SL,2005,2013,8,9,0,29,0,9.22,107,77.57,0,0,1,83,2005
DJM Short,AUS,2018,2018,0,4,1,47,1,27.66,99,83.83,0,0,1,83,2018
R Strydom,IRE,2008,2008,0,6,0,37,0,13.83,155,53.54,0,0,0,83,2008
RGD Willis,ENG,1973,1984,11,22,0,24,14,10.37,157,52.86,0,0,4,83,1973
RR David,CAN,2008,2010,2,3,0,48,0,27.33,170,48.23,0,0,0,82,2008
C Hemraj,WI,2018,2018,0,6,0,32,0,13.66,98,83.67,0,0,0,82,2018
LJ Koen,SA,1997,2000,3,5,0,28,0,16.4,169,48.52,0,0,1,82,1997
DB Kotze,NAM,2003,2003,0,6,0,27,1,16.4,135,60.74,0,0,0,82,2003
Nasir Aziz,UAE,2014,2015,1,3,0,60,0,27.33,125,65.6,0,1,0,82,2014
RD Robinson,AUS,1977,1977,0,2,0,70,0,41.0,143,57.34,0,1,0,82,1977
MC Henriques,AUS,2009,2017,8,10,0,18,1,9.0,119,68.06,0,0,0,81,2009
Mahbubul Alam,BDESH,2009,2009,0,2,0,59,0,40.5,71,114.08,0,1,0,81,2009
AM Phangiso,SA,2013,2016,3,13,0,20,2,7.36,162,50.0,0,0,3,81,2013
GA Rogers,SCOT,2006,2008,2,8,0,26,3,16.2,169,47.92,0,0,1,81,2006
Shahid Wasif,HKG,2016,2018,2,7,0,45,0,11.57,163,49.69,0,0,1,81,2016
JJ Smit,NAM,2019,2019,0,5,0,33,1,20.25,114,71.05,0,0,0,81,2019
S Sriram,INDIA,2000,2004,4,7,0,57,1,13.5,135,60.0,0,1,1,81,2000
Syed Rasel,BDESH,2005,2010,5,27,0,15,11,5.06,185,43.78,0,0,5,81,2005
JNT Vare,PNG,2014,2018,4,9,0,28,1,10.12,110,73.63,0,0,0,81,2014
Jai P Yadav,INDIA,2002,2005,3,7,0,69,3,20.25,123,65.85,0,1,2,81,2002
Aftab Alam,AFG,2010,2019,9,17,1,16,10,11.42,107,74.76,0,0,3,80,2010
G Goudie,SCOT,2008,2013,5,11,0,23,3,10.0,99,80.8,0,0,2,80,2008
TR Gripper,ZIM,2001,2003,2,8,0,26,0,10.0,187,42.78,0,0,1,80,2001
Hammad Azam,PAK,2011,2015,4,7,0,36,2,16.0,131,61.06,0,0,0,80,2011
PWE Rawson,ZIM,1983,1987,4,8,1,24,3,16.0,123,65.04,0,0,1,80,1983
SK Sharma,INDIA,1988,1990,2,12,0,28,4,10.0,135,59.25,0,0,2,80,1988
TD Astle,NZ,2017,2019,2,5,0,49,2,26.33,77,102.59,0,0,0,79,2017
S Badrinath,INDIA,2008,2011,3,6,1,27,1,15.8,172,45.93,0,0,0,79,2008
Shahadat Hossain,BDESH,2006,2013,7,27,1,16,17,7.9,151,52.31,0,0,3,79,2006
MHN Walker,AUS,1974,1981,7,11,0,20,3,9.87,170,46.47,0,0,1,79,1974
UT Yadav,INDIA,2010,2018,8,24,1,18,14,7.9,134,58.95,0,0,4,79,2010
AC Dale,AUS,1997,2000,3,12,1,15,8,19.5,136,57.35,0,0,1,78,1997
MF Kent,AUS,1981,1981,0,5,0,33,1,19.5,133,58.64,0,0,0,78,1981
Mustafizur Rahman,BDESH,2015,2019,4,27,1,18,17,7.8,136,57.35,0,0,4,78,2015
MW Rushmere,SA,1992,1992,0,4,0,35,0,19.5,174,44.82,0,0,0,78,1992
Sami Aslam,PAK,2015,2016,1,4,0,45,0,19.5,117,66.66,0,0,0,78,2015
MH Tissera,SL,1975,1975,0,3,0,52,0,26.0,147,53.06,0,1,0,78,1975
NM Lyon,AUS,2012,2019,7,14,0,30,10,19.25,83,92.77,0,0,1,77,2012
KJ Abbott,SA,2013,2016,3,13,0,23,4,8.44,126,60.31,0,0,1,76,2013
TL Best,WI,2004,2014,10,16,0,24,8,9.5,125,60.8,0,0,1,76,2004
SS Cottrell,WI,2015,2019,4,14,0,17,7,10.85,103,73.78,0,0,1,76,2015
IG Holland,USA,2019,2019,0,4,0,44,0,19.0,92,82.6,0,0,0,76,2019
CA Lynn,AUS,2017,2018,1,4,0,44,0,18.75,89,84.26,0,0,1,75,2017
AP Sheahan,AUS,1972,1972,0,3,0,50,0,25.0,124,60.48,0,1,0,75,1972
KDK Vithanage,SL,2013,2014,1,6,0,27,1,15.0,90,83.33,0,0,0,75,2013
NG Jones,IRE,2010,2011,1,9,1,25,4,14.8,102,72.54,0,0,0,74,2010
MS Kasprowicz,AUS,1995,2005,10,13,1,28,9,18.5,89,83.14,0,0,2,74,1995
PWA Mulder,SA,2017,2019,2,8,1,19,3,14.8,89,83.14,0,0,0,74,2017
MM Patel,INDIA,2006,2011,5,27,0,15,16,6.72,112,66.07,0,0,4,74,2006
Yasir Arafat,PAK,2000,2009,9,8,0,27,3,14.8,110,67.27,0,0,0,74,2000
FH Edwards,WI,2003,2009,6,22,0,13,14,9.12,160,45.62,0,0,2,73,2003
CK Langeveldt,SA,2001,2010,9,21,0,12,10,6.63,124,58.87,0,0,1,73,2001
EB McSweeney,NZ,1986,1987,1,14,1,18,5,8.11,119,61.34,0,0,2,73,1986
GR Sealy,CAN,1979,1979,0,3,0,45,0,24.33,149,48.99,0,0,0,73,1979
CS Serjeant,AUS,1977,1978,1,3,0,46,0,24.33,158,46.2,0,0,0,73,1977
R Telemachus,SA,1998,2006,8,15,0,29,3,6.08,94,77.65,0,0,2,73,1998
AL Wadekar,INDIA,1974,1974,0,2,0,67,0,36.5,90,81.11,0,1,0,73,1974
DS Weerakkody,SL,2017,2017,0,3,0,58,0,24.33,66,110.6,0,1,0,73,2017
G Blakeney,BMUDA,2009,2009,0,2,0,42,0,36.0,69,104.34,0,0,0,72,2009
TG Hogan,AUS,1983,1984,1,12,0,27,4,9.0,95,75.78,0,0,1,72,1983
BA Murphy,ZIM,2000,2003,3,17,1,20,8,8.0,130,55.38,0,0,1,72,2000
OL Pitcher,BMUDA,2007,2007,0,5,0,30,0,14.4,217,33.17,0,0,1,72,2007
I Sharma,INDIA,2007,2016,9,28,0,13,13,4.8,203,35.46,0,0,5,72,2007
S Viswanath,INDIA,1985,1988,3,12,1,23,4,9.0,139,51.79,0,0,0,72,1985
CJ Adams,ENG,1998,2000,2,4,0,42,0,17.75,144,49.3,0,0,0,71,1998
DI Allan,KENYA,2011,2013,2,5,0,27,0,14.2,153,46.4,0,0,0,71,2011
SA Edwards,NL,2018,2019,1,3,1,44,1,35.5,81,87.65,0,0,0,71,2018
EH Hutchinson,USA,2019,2019,0,3,1,42,1,35.5,49,144.89,0,0,0,71,2019
MJG Rippon,NL,2013,2018,5,4,0,51,1,23.66,112,63.39,0,1,0,71,2013
JDF Vandersay,SL,2015,2019,4,7,0,25,1,11.83,166,42.77,0,0,1,71,2015
KED Carroll,IRE,2007,2007,0,6,0,28,0,11.66,126,55.55,0,0,1,70,2007
SR Gillespie,NZ,1986,1988,2,11,1,18,5,11.66,106,66.03,0,0,1,70,1986
Shuvagata Hom,BDESH,2011,2011,0,3,1,35,1,35.0,86,81.39,0,0,0,70,2011
MJ Smith,ENG,1973,1974,1,5,0,31,0,14.0,159,44.02,0,0,1,70,1973
RD Steede,BMUDA,2006,2008,2,7,0,20,1,11.66,142,49.29,0,0,0,70,2006
Ashraf Ali,PAK,1980,1985,5,9,1,19,5,17.25,135,51.11,0,0,1,69,1980
SR Clark,AUS,2005,2009,4,12,1,16,7,13.8,88,78.4,0,0,1,69,2005
AC Dawson,SA,1998,2004,6,7,1,23,4,23.0,67,102.98,0,0,0,69,1998
Y Goonasekera,SL,1983,1983,0,3,0,35,0,23.0,104,66.34,0,0,0,69,1983
SP Khakurel,NEPAL,2018,2018,0,2,0,50,0,34.5,130,53.07,0,1,0,69,2018
Mujeeb Ur Rahman,AFG,2017,2019,2,21,0,15,10,6.27,79,87.34,0,0,7,69,2017
TP Visee,NL,2019,2019,0,2,0,41,0,34.5,56,123.21,0,0,0,69,2019
FS Crockwell,BMUDA,2009,2009,0,2,0,45,0,34.0,104,65.38,0,0,0,68,2009
TGJ Gruijters,NL,2010,2013,3,4,0,32,1,22.66,116,58.62,0,0,0,68,2010
OJ Hairs,SCOT,2010,2010,0,5,0,27,0,13.6,100,68.0,0,0,0,68,2010
Iftikhar Ahmed,PAK,2015,2019,4,4,1,32,2,34.0,73,93.15,0,0,0,68,2015
RK Illingworth,ENG,1991,1996,5,11,0,14,5,11.33,119,57.14,0,0,0,68,1991
Jatinder Singh,OMAN,2019,2019,0,5,0,23,0,13.6,137,49.63,0,0,1,68,2019
Junaid Khan,PAK,2011,2019,8,31,0,25,17,4.85,127,53.54,0,0,6,68,2011
SO Ngoche,KENYA,2010,2014,4,12,0,28,3,7.55,119,57.14,0,0,4,68,2010
Nurul Hasan,BDESH,2016,2016,0,2,0,44,0,34.0,70,97.14,0,0,0,68,2016
JA Richardson,AUS,2018,2019,1,7,0,29,2,13.6,84,80.95,0,0,0,68,2018
M Sheikh,KENYA,1997,2000,3,15,1,15,5,6.8,123,55.28,0,0,2,68,1997
SJ Cook,SA,1991,1993,2,4,0,35,0,16.75,118,56.77,0,0,1,67,1991
SG Davies,ZIM,1996,1996,0,4,0,45,0,16.75,173,38.72,0,0,0,67,1996
Junaid Siddiqui,CAN,2011,2014,3,8,0,25,3,13.4,144,46.52,0,0,1,67,2011
N Madziva,ZIM,2014,2016,2,12,0,25,3,7.44,138,48.55,0,0,2,67,2014
HJC Mol,NL,2002,2008,6,9,0,23,1,8.37,183,36.61,0,0,2,67,2002
Nadeem Ahmed,HKG,2004,2018,14,16,0,14,4,5.58,151,44.37,0,0,1,67,2004
V Pollard,NZ,1973,1974,1,2,0,55,0,33.5,145,46.2,0,1,0,67,1973
Shapoor Zadran,AFG,2009,2019,10,27,0,17,17,6.7,160,41.87,0,0,4,67,2009
IS Sodhi,NZ,2015,2019,4,13,0,24,2,6.09,88,76.13,0,0,4,67,2015
Waqas Khan,HKG,2015,2017,2,5,1,35,1,16.75,137,48.9,0,0,0,67,2015
PR Adams,SA,1996,2003,7,9,1,33,5,16.5,124,53.22,0,0,2,66,1996
Akhtar Sarfraz,PAK,1997,1998,1,4,0,25,0,16.5,99,66.66,0,0,0,66,1997
RJ Bright,AUS,1974,1986,12,8,1,19,4,16.5,122,54.09,0,0,1,66,1974
Sharafuddin Ashraf,AFG,2014,2019,5,10,0,21,3,9.42,100,66.0,0,0,2,66,2014
OO Bascome,BMUDA,2008,2008,0,6,0,20,0,10.83,145,44.82,0,0,0,65,2008
KCG Benjamin,WI,1992,1996,4,13,0,17,7,10.83,80,81.25,0,0,1,65,1992
RD King,WI,1998,2005,7,23,1,12,14,7.22,203,32.01,0,0,5,65,1998
RG Petrie,NZ,1990,1991,1,8,0,21,3,13.0,109,59.63,0,0,1,65,1990
Saeed Azad,PAK,1995,1996,1,4,0,31,0,16.25,131,49.61,0,0,0,65,1995
VA Holder,WI,1973,1978,5,6,0,30,1,12.8,85,75.29,0,0,1,64,1973
H Osinde,CAN,2006,2013,7,28,1,21,13,4.26,130,49.23,0,0,7,64,2006
KF Semple,WI,1999,1999,0,6,0,23,0,10.66,165,38.78,0,0,0,64,1999
RO Hussain,SCOT,2006,2010,4,8,0,17,1,9.0,143,44.05,0,0,0,63,2006
PD McGlashan,NZ,2009,2009,0,2,1,56,1,63.0,51,123.52,0,1,0,63,2009
MQ Sheikh,SCOT,2008,2010,2,7,0,23,1,10.5,140,45.0,0,0,0,63,2008
Taijul Islam,BDESH,2014,2019,5,4,1,39,1,21.0,77,81.81,0,0,0,63,2014
Adnan Akmal,PAK,2011,2012,1,4,0,27,1,20.66,89,69.66,0,0,0,62,2011
SD Anurasiri,SL,1986,1994,8,18,0,11,12,10.33,143,43.35,0,0,2,62,1986
DE Budge,SCOT,2018,2019,1,3,0,27,0,20.66,70,88.57,0,0,0,62,2018
PG Coman,NZ,1973,1974,1,3,0,38,0,20.66,104,59.61,0,0,1,62,1973
CE Cuffy,WI,1994,2002,8,22,1,17,8,4.42,125,49.6,0,0,5,62,1994
LH Ferguson,NZ,2016,2019,3,15,0,19,7,7.75,125,49.6,0,0,4,62,2016
SN Netravalkar,USA,2019,2019,0,7,1,19,3,15.5,91,68.13,0,0,0,62,2019
JB Reva,PNG,2016,2018,2,7,0,36,1,10.33,83,74.69,0,0,1,62,2016
Shaheedur Rahman,BDESH,1986,1986,0,2,0,37,0,31.0,108,57.4,0,0,0,62,1986
Azhar Saeed,UAE,1994,1996,2,7,0,32,0,8.71,195,31.28,0,0,1,61,1994
Dolar Mahmud,BDESH,2008,2009,1,4,0,41,0,15.25,44,138.63,0,0,2,61,2008
BT Foakes,ENG,2019,2019,0,1,1,61,1,0.0,76,80.26,0,1,0,61,2019
MN Hart,NZ,1994,2002,8,8,0,16,0,7.62,101,60.39,0,0,1,61,1994
JD Love,ENG,1981,1981,0,3,0,43,0,20.33,100,61.0,0,0,0,61,1981
EO Odumbe,KENYA,1996,1996,0,7,0,20,1,10.16,150,40.66,0,0,0,61,1996
DR Parry,WI,1978,1980,2,5,0,32,1,15.25,77,79.22,0,0,0,61,1978
Shakeel Ahmed jnr,PAK,1995,1995,0,2,0,36,0,30.5,128,47.65,0,0,0,61,1995
L Sreekumar,UAE,2015,2016,1,4,0,28,0,15.25,73,83.56,0,0,0,61,2015
ELR Stewart,SA,1993,2002,9,6,1,23,2,15.25,116,52.58,0,0,0,61,1993
DS Wesonga,KENYA,2010,2011,1,4,0,33,1,20.33,108,56.48,0,0,0,61,2010
RM West,IRE,2008,2009,1,4,1,29,2,30.5,41,148.78,0,0,1,61,2008
GE Bradburn,NZ,1990,2001,11,10,0,30,3,8.57,130,46.15,0,0,1,60,1990
JJ Celestine,BMUDA,2007,2008,1,8,0,20,0,7.5,135,44.44,0,0,1,60,2007
ST Clarke,WI,1978,1982,4,8,0,20,2,10.0,58,103.44,0,0,1,60,1978
Humayun Farhat,PAK,2001,2001,0,3,0,39,0,20.0,56,107.14,0,0,0,60,2001
JA Jameson,ENG,1973,1975,2,3,0,28,0,20.0,158,37.97,0,0,0,60,1973
NC McGarrell,WI,1998,2001,3,10,0,19,2,7.5,98,61.22,0,0,2,60,1998
Abdul Jabbar,CAN,2007,2007,0,2,0,44,0,29.5,82,71.95,0,0,0,59,2007
WD Balaji Rao,CAN,2008,2011,3,8,0,24,0,7.37,89,66.29,0,0,0,59,2008
Gazi Ashraf,BDESH,1986,1990,4,7,0,18,0,8.42,239,24.68,0,0,1,59,1986
MBS Jonkman,NL,2006,2010,4,9,0,16,4,11.8,79,74.68,0,0,1,59,2006
MA Parker,SCOT,2010,2010,0,8,0,22,2,9.83,104,56.73,0,0,0,59,2010
RO Butcher,ENG,1980,1981,1,3,0,52,0,19.33,68,85.29,0,1,0,58,1980
Imran Haider,UAE,2017,2019,2,14,1,18,7,8.28,136,42.64,0,0,3,58,2017
TMK Mawoyo,ZIM,2006,2014,8,7,0,15,0,8.28,160,36.25,0,0,1,58,2006
D Murphy,SCOT,2013,2013,0,7,1,20,2,11.6,118,49.15,0,0,0,58,2013
Saqlain Haider,UAE,2014,2016,2,4,0,28,0,14.5,77,75.32,0,0,0,58,2014
M van Schoor,NAM,2003,2003,0,5,0,24,1,14.5,111,52.25,0,0,0,58,2003
BM Wheeler,NZ,2015,2015,0,4,1,39,4,0.0,47,123.4,0,0,0,58,2015
B Yardley,AUS,1978,1983,5,4,0,28,0,14.5,98,59.18,0,0,1,58,1978
KD Boyce,WI,1973,1975,2,4,0,34,0,14.25,77,74.02,0,0,0,57,1973
Ehsanul Haque,BDESH,2002,2003,1,6,0,20,0,9.5,129,44.18,0,0,1,57,2002
Frasat Ali,EAf,1975,1975,0,3,0,45,0,19.0,176,32.38,0,0,1,57,1975
G Salmond,SCOT,1999,1999,0,5,0,31,0,11.4,109,52.29,0,0,0,57,1999
AJ Tye,AUS,2018,2018,0,7,0,19,3,14.25,48,118.75,0,0,0,57,2018
V Aravind,UAE,2019,2019,0,3,0,23,0,18.66,73,76.71,0,0,0,56,2019
RS Haire,IRE,2008,2008,0,2,0,54,0,28.0,72,77.77,0,1,0,56,2008
JK Lever,ENG,1976,1982,6,11,1,27,4,8.0,152,36.84,0,0,1,56,1976
NM Odhiambo,KENYA,2010,2013,3,6,0,29,0,9.33,121,46.28,0,0,0,56,2010
Sohail Fazal,PAK,1989,1989,0,2,0,32,0,28.0,59,94.91,0,0,0,56,1989
LL Tsotsobe,SA,2009,2013,4,21,1,16,13,7.0,109,51.37,0,0,3,56,2009
MA Wood,ENG,2015,2019,4,17,0,13,10,8.0,63,88.88,0,0,3,56,2015
MW Douglas,NZ,1994,1995,1,6,0,30,0,9.16,123,44.71,0,0,1,55,1994
FY Fazal,INDIA,2016,2016,0,1,1,55,1,0.0,61,90.16,0,1,0,55,2016
TV Mufambisi,ZIM,2006,2007,1,6,0,21,0,9.16,90,61.11,0,0,0,55,2006
SJ Palframan,SA,1996,1996,0,4,0,28,0,13.75,80,68.75,0,0,0,55,1996
TK Patel,USA,2019,2019,0,5,1,50,3,27.5,102,53.92,0,1,0,55,2019
EC Rainsford,ZIM,2004,2010,6,23,1,9,13,5.5,134,41.04,0,0,2,55,2004
SK Ranasinghe,SL,1986,1986,0,3,0,41,0,18.33,81,67.9,0,0,1,55,1986
Abdul Shakoor,UAE,2015,2018,3,3,0,24,0,18.0,102,52.94,0,0,0,54,2015
Arshad Ali,UAE,2004,2008,4,4,0,41,0,13.5,102,52.94,0,0,1,54,2004
RJ Campbell,AUS,2002,2002,0,2,0,38,0,27.0,70,77.14,0,0,0,54,2002
RD Jackman,ENG,1974,1983,9,9,0,14,1,6.75,93,58.06,0,0,1,54,1974
RWT Key,ENG,2003,2004,1,5,0,19,0,10.8,135,40.0,0,0,1,54,2003
J Kila,PNG,2018,2019,1,6,0,21,2,13.5,63,85.71,0,0,1,54,2018
BJ McKechnie,NZ,1975,1981,6,8,0,27,4,13.5,145,37.24,0,0,1,54,1975
Mohammad Iqbal,CAN,2007,2008,1,5,0,30,0,10.8,80,67.5,0,0,1,54,2007
JV Paranjpe,INDIA,1998,1998,0,4,0,27,1,18.0,91,59.34,0,0,0,54,1998
RG Samuels,WI,1996,1997,1,5,1,36,2,18.0,63,85.71,0,0,0,54,1996
RK Sethi,EAf,1975,1975,0,3,0,30,0,18.0,185,29.18,0,0,0,54,1975
S Venkataraghavan,INDIA,1974,1983,9,9,1,26,4,10.8,126,42.85,0,0,2,54,1974
BCJ Cutting,AUS,2013,2014,1,2,0,27,0,26.5,67,79.1,0,0,0,53,2013
Ghulam Ali,PAK,1993,1995,2,3,0,38,0,17.66,121,43.8,0,0,0,53,1993
Mafizur Rahman,BDESH,1997,1997,0,4,0,16,1,17.66,104,50.96,0,0,0,53,1997
Manjural Islam,BDESH,1999,2003,4,22,0,13,13,5.88,134,39.55,0,0,4,53,1999
WP Masakadza,ZIM,2015,2018,3,10,0,15,1,5.88,125,42.4,0,0,3,53,2015
Mohammad Sharif,BDESH,2001,2007,6,9,1,13,5,13.25,102,51.96,0,0,1,53,2001
RAP Nissanka,SL,2001,2003,2,13,0,11,5,6.62,140,37.85,0,0,2,53,2001
DL Underwood,ENG,1973,1982,9,13,0,17,4,5.88,133,39.84,0,0,2,53,1973
CAK Walton,WI,2009,2017,8,8,0,19,0,6.62,86,61.62,0,0,4,53,2009
AJ Woodcock,AUS,1974,1974,0,1,0,53,0,53.0,67,79.1,0,1,0,53,1974
JE Brinkley,SCOT,1999,1999,0,5,0,23,0,10.4,118,44.06,0,0,1,52,1999
TK Canning,NZ,2003,2005,2,4,1,23,1,17.33,73,71.23,0,0,1,52,2003
JS Malhotra,USA,2019,2019,0,5,0,18,0,10.4,71,73.23,0,0,1,52,2019
B Mavuta,ZIM,2018,2019,1,5,0,20,1,13.0,47,110.63,0,0,1,52,2018
AK Perera,SL,2013,2019,6,4,0,31,0,13.0,83,62.65,0,0,0,52,2013
N Pokana,PNG,2017,2019,2,9,1,11,4,10.4,106,49.05,0,0,1,52,2017
Zahoor Khan,UAE,2017,2019,2,13,0,16,4,5.77,77,67.53,0,0,3,52,2017
CS Cowdrey,ENG,1985,1985,0,3,1,46,1,25.5,46,110.86,0,0,1,51,1985
D Dasgupta,INDIA,2001,2001,0,4,1,24,1,17.0,82,62.19,0,0,1,51,2001
AH Gray,WI,1985,1991,6,11,1,10,5,8.5,77,66.23,0,0,1,51,1985
A Mithun,INDIA,2010,2011,1,3,0,24,0,17.0,55,92.72,0,0,0,51,2010
CA Pujara,INDIA,2013,2014,1,5,0,27,0,10.2,130,39.23,0,0,2,51,2013
KW Richardson,AUS,2013,2019,6,10,0,19,5,10.2,56,91.07,0,0,2,51,2013
BS Sandhu,INDIA,1982,1984,2,7,1,16,3,12.75,97,52.57,0,0,2,51,1982
DE Bollinger,AUS,2009,2011,2,8,0,30,2,8.33,54,92.59,0,0,1,50,2009
NE Clarke,NL,1996,1996,0,5,0,32,0,10.0,112,44.64,0,0,2,50,1996
JG Heron,ZIM,1983,1983,0,6,0,18,0,8.33,163,30.67,0,0,1,50,1983
PA Horne,NZ,1987,1987,0,4,0,18,0,12.5,122,40.98,0,0,1,50,1987
J Lewis,ENG,2005,2007,2,8,0,17,2,8.33,63,79.36,0,0,0,50,2005
D Ravu,PNG,2017,2019,2,7,1,38,3,12.5,79,63.29,0,0,2,50,2017
IM Stanger,SCOT,1999,2006,7,5,0,27,0,10.0,150,33.33,0,0,0,50,1999
CT Tremlett,ENG,2005,2011,6,11,1,19,4,7.14,89,56.17,0,0,1,50,2005
Zeeshan Siddiqi,CAN,2012,2014,2,2,0,43,0,25.0,111,45.04,0,0,0,50,2012
ST Banerjee,INDIA,1991,1992,1,5,1,25,3,24.5,42,116.66,0,0,0,49,1991
DB Close,ENG,1972,1972,0,3,0,43,0,16.33,50,98.0,0,0,0,49,1972
WW Daniel,WI,1978,1984,6,5,1,16,4,49.0,56,87.5,0,0,0,49,1978
DJ Gandhi,INDIA,1999,2000,1,3,0,30,0,16.33,97,50.51,0,0,0,49,1999
CK Hooper,CAN,2007,2010,3,5,0,27,2,16.33,60,81.66,0,0,1,49,2007
Maninder Singh,INDIA,1983,1993,10,18,1,8,14,12.25,90,54.44,0,0,1,49,1983
E Otieno,KENYA,2007,2014,7,17,0,11,7,4.9,136,36.02,0,0,5,49,2007
D Ranatunga,SL,1990,1990,0,4,0,25,0,12.25,156,31.41,0,0,1,49,1990
BA Reid,AUS,1986,1992,6,21,0,10,8,3.76,117,41.88,0,0,1,49,1986
GK Robertson,NZ,1981,1989,8,6,0,17,0,8.16,48,102.08,0,0,1,49,1981
MMC Schewe,NL,1996,1996,0,4,0,20,1,16.33,68,72.05,0,0,0,49,1996
SS Tiwary,INDIA,2010,2010,0,2,1,37,2,0.0,56,87.5,0,0,0,49,2010
KEA Upashantha,SL,1995,2001,6,8,0,15,1,7.0,86,56.97,0,0,0,49,1995
Arafat Sunny,BDESH,2014,2015,1,11,0,15,7,12.0,92,52.17,0,0,1,48,2014
GG Arnold,ENG,1972,1975,3,6,1,18,3,16.0,75,64.0,0,0,1,48,1972
JH Hampshire,ENG,1971,1972,1,3,1,25,1,24.0,86,55.81,0,0,0,48,1971
RJ Harris,AUS,2009,2012,3,13,0,21,7,8.0,48,100.0,0,0,0,48,2009
Mohammad Irfan,PAK,2010,2016,6,33,0,12,21,4.0,149,32.21,0,0,8,48,2010
CB Mpofu,ZIM,2004,2019,15,40,0,6,20,2.4,202,23.76,0,0,7,48,2004
MW Pringle,SA,1992,1994,2,8,1,13,3,9.6,56,85.71,0,0,1,48,1992
PC Strydom,SA,2000,2000,0,8,0,34,3,9.6,94,51.06,0,0,1,48,2000
MG Vandort,SL,2006,2006,0,1,0,48,0,48.0,117,41.02,0,0,0,48,2006
JJ Whitaker,ENG,1987,1987,0,2,1,44,1,48.0,65,73.84,0,0,0,48,1987
Zafar Iqbal,PAK,1995,1995,0,6,0,18,0,8.0,62,77.41,0,0,1,48,1995
Zulqarnain Haider,PAK,2010,2010,0,4,1,19,2,24.0,68,70.58,0,0,0,48,2010
A Codrington,CAN,2003,2007,4,8,0,16,0,5.87,92,51.08,0,0,2,47,2003
FA Dennis,CAN,1979,1979,0,3,0,25,0,15.66,171,27.48,0,0,0,47,1979
Fayyaz Ahmed,UAE,2014,2016,2,3,1,37,2,47.0,100,47.0,0,0,0,47,2014
ER Fernando,SL,1975,1975,0,3,0,22,0,15.66,66,71.21,0,0,0,47,1975
L Ngidi,SA,2018,2019,1,9,1,19,6,15.66,66,71.21,0,0,0,47,2018
Sarandeep Singh,INDIA,2002,2003,1,4,0,19,1,15.66,73,64.38,0,0,0,47,2002
BGK Walker,NZ,2000,2002,2,7,1,16,4,15.66,79,59.49,0,0,0,47,2000
Jawahir Shah,EAf,1975,1975,0,3,0,37,0,15.33,114,40.35,0,0,0,46,1975
KK Nair,INDIA,2016,2016,0,2,0,39,0,23.0,88,52.27,0,0,0,46,2016
J Nyumbu,ZIM,2014,2015,1,14,0,18,4,4.6,89,51.68,0,0,3,46,2014
PP Ojha,INDIA,2008,2012,4,10,1,16,8,23.0,112,41.07,0,0,0,46,2008
IR Redpath,AUS,1971,1975,4,5,0,24,0,9.2,67,68.65,0,0,1,46,1971
Skhawat Ali,HKG,2008,2014,6,4,0,28,0,11.5,109,42.2,0,0,1,46,2008
TB Sole,SCOT,2018,2019,1,7,0,20,1,7.66,43,106.97,0,0,0,46,2018
Azeem Hafeez,PAK,1983,1985,2,10,0,15,7,15.0,104,43.26,0,0,1,45,1983
M Karg,NAM,2003,2003,0,2,0,41,0,22.5,65,69.23,0,0,0,45,2003
DA Murray,WI,1973,1981,8,7,0,35,2,9.0,140,32.14,0,0,1,45,1973
GR Robertson,AUS,1994,1998,4,7,0,15,4,15.0,55,81.81,0,0,0,45,1994
S Thuraisingam,CAN,2003,2008,5,9,0,13,2,6.42,108,41.66,0,0,1,45,2003
PJ Wiseman,NZ,1998,2003,5,7,0,16,5,22.5,83,54.21,0,0,0,45,1998
VR Brown,NZ,1988,1988,0,3,0,32,0,14.66,85,51.76,0,0,0,44,1988
NA de Groot,CAN,2003,2003,0,6,0,17,0,7.33,127,34.64,0,0,3,44,2003
Golam Faruq,BDESH,1986,1990,4,4,1,23,2,22.0,104,42.3,0,0,0,44,1986
AV Mankad,INDIA,1974,1974,0,1,0,44,0,44.0,61,72.13,0,0,0,44,1974
RD McCann,IRE,2010,2010,0,5,0,18,1,11.0,77,57.14,0,0,1,44,2010
BP Patterson,WI,1986,1993,7,20,1,13,15,8.8,101,43.56,0,0,1,44,1986
RH Poonawala,UAE,1994,1994,0,2,0,22,0,22.0,56,78.57,0,0,0,44,1994
S Sreesanth,INDIA,2005,2011,6,21,1,10,10,4.0,121,36.36,0,0,3,44,2005
JH Stander,SCOT,2009,2012,3,5,1,22,1,11.0,75,58.66,0,0,1,44,2009
HR Bryan,WI,1999,1999,0,8,0,11,2,7.16,71,60.56,0,0,1,43,1999
Faisal Hossain,BDESH,2004,2010,6,5,0,17,1,10.75,91,47.25,0,0,1,43,2004
KHRK Fernando,SL,2002,2006,4,5,1,23,3,21.5,72,59.72,0,0,0,43,2002
AR Kapoor,INDIA,1995,2000,5,6,0,19,0,7.16,63,68.25,0,0,3,43,1995
A Mishra,INDIA,2003,2016,13,11,0,14,3,5.37,82,52.43,0,0,2,43,2003
Salman Faris,UAE,2014,2014,0,3,0,27,0,14.33,79,54.43,0,0,1,43,2014
WN Slack,ENG,1986,1986,0,2,0,34,0,21.5,85,50.58,0,0,0,43,1986
GB Stevenson,ENG,1980,1981,1,4,1,28,3,43.0,56,76.78,0,0,0,43,1980
SJ Swanepoel,NAM,2003,2003,0,5,0,23,0,8.6,94,45.74,0,0,0,43,2003
Anwar Hossain,BDESH,2002,2002,0,1,0,42,0,42.0,107,39.25,0,0,0,42,2002
Azmat Rana,PAK,1978,1978,0,2,1,22,1,42.0,73,57.53,0,0,0,42,1978
MJ Fourie,IRE,2007,2008,1,5,1,19,3,21.0,51,82.35,0,0,0,42,2007
GJ Gilmour,AUS,1974,1975,1,2,1,28,1,42.0,39,107.69,0,0,0,42,1974
JN Maguire,AUS,1983,1984,1,11,1,14,5,7.0,71,59.15,0,0,1,42,1983
JL Pattinson,AUS,2011,2015,4,8,0,13,4,10.5,80,52.5,0,0,0,42,2011
MH Richardson,NZ,2002,2002,0,4,0,26,0,10.5,97,43.29,0,0,1,42,2002
Shaheen Shah Afridi,PAK,2018,2019,1,8,1,19,6,21.0,64,65.62,0,0,1,42,2018
JS Foster,ENG,2001,2002,1,6,0,13,3,13.66,71,57.74,0,0,0,41,2001
SP Heaney,CAN,2006,2006,0,4,0,19,0,10.25,92,44.56,0,0,0,41,2006
PA Hitchcock,NZ,2002,2008,6,7,1,11,3,10.25,61,67.21,0,0,1,41,2002
Mehmood Quaraishy,EAf,1975,1975,0,3,0,19,1,20.5,154,26.62,0,0,0,41,1975
WP Saha,INDIA,2010,2014,4,5,0,16,2,13.66,56,73.21,0,0,0,41,2010
Shafiq Ahmed,PAK,1977,1978,1,3,0,29,0,13.66,91,45.05,0,0,0,41,1977
Taskin Ahmed,BDESH,2014,2017,3,16,0,14,6,4.1,99,41.41,0,0,3,41,2014
SR Welsh,CAN,2006,2008,2,3,0,32,1,20.5,78,52.56,0,0,0,41,2006
Bilal Asif,PAK,2015,2015,0,3,0,38,0,13.33,49,81.63,0,0,1,40,2015
PC Connell,IRE,2008,2010,2,5,1,22,3,20.0,73,54.79,0,0,1,40,2008
DR Hadlee,NZ,1973,1976,3,7,0,20,2,8.0,85,47.05,0,0,3,40,1973
Khaliq Dad,AFG,2009,2010,1,4,0,20,1,13.33,69,57.97,0,0,1,40,2009
S Lamichhane,NEPAL,2018,2019,1,5,0,15,1,10.0,69,57.97,0,0,0,40,2018
PS Masvaure,ZIM,2018,2018,0,2,0,39,0,20.0,60,66.66,0,0,0,40,2018
Mohammad Nadeem,OMAN,2019,2019,0,3,1,29,1,20.0,89,44.94,0,0,0,40,2019
ML Patel,KENYA,2004,2006,2,3,0,25,0,13.33,95,42.1,0,0,1,40,2004
SJ Rixon,AUS,1978,1985,7,6,1,20,3,13.33,98,40.81,0,0,1,40,1978
DJ ter Braak,NL,2018,2018,0,2,0,39,0,20.0,94,42.55,0,0,0,40,2018
MR Whitney,AUS,1983,1993,10,13,1,9,7,6.66,90,44.44,0,0,1,40,1983
GA Briant,ZIM,1993,1993,0,5,0,16,2,13.0,69,56.52,0,0,1,39,1993
YS Chahal,INDIA,2016,2019,3,8,1,18,3,7.8,72,54.16,0,0,1,39,2016
SS Das,INDIA,2001,2002,1,4,0,30,1,13.0,77,50.64,0,0,0,39,2001
KSC de Silva,SL,1996,2000,4,19,1,13,13,6.5,92,42.39,0,0,4,39,1996
DR Gilbert,AUS,1986,1986,0,8,0,8,3,7.8,102,38.23,0,0,0,39,1986
Iqbal Qasim,PAK,1977,1988,11,7,0,13,1,6.5,90,43.33,0,0,2,39,1977
BA King,WI,2019,2019,0,1,0,39,0,39.0,56,69.64,0,0,0,39,2019
N Kruger,NL,2011,2011,0,2,0,34,0,19.5,75,52.0,0,0,0,39,2011
GD Lloyd,ENG,1996,1998,2,5,0,22,1,9.75,80,48.75,0,0,2,39,1996
TBA May,AUS,1987,1995,8,12,0,15,8,9.75,52,75.0,0,0,0,39,1987
LS Pascoe,AUS,1977,1982,5,11,1,15,7,9.75,102,38.23,0,0,2,39,1977
Ramveer Rai,UAE,2004,2004,0,1,0,39,0,39.0,124,31.45,0,0,0,39,2004
RH Scholte,NL,2002,2003,1,5,0,12,0,7.8,135,28.88,0,0,0,39,2002
A Shahzad,ENG,2010,2011,1,8,0,9,2,6.5,60,65.0,0,0,0,39,2010
SN Thakur,INDIA,2017,2019,2,3,1,22,2,39.0,22,177.27,0,0,1,39,2017
Zulfiqar Ali,EAf,1975,1975,0,3,0,30,1,19.5,76,51.31,0,0,0,39,1975
JT Ball,ENG,2016,2018,2,6,0,28,2,9.5,49,77.55,0,0,2,38,2016
CJD Chappell,CAN,1979,1979,0,3,0,19,0,12.66,143,26.57,0,0,0,38,1979
PP Chawla,INDIA,2007,2011,4,12,1,13,5,5.42,58,65.51,0,0,1,38,2007
CKB Kulasekara,SL,2011,2012,1,3,0,19,0,12.66,72,52.77,0,0,1,38,2011
PJ Martin,ENG,1995,1998,3,13,0,6,7,6.33,53,71.69,0,0,0,38,1995
Mohammad Aslam,UAE,1996,1996,0,4,0,23,0,9.5,73,52.05,0,0,0,38,1996
N M'shangwe,ZIM,2011,2014,3,6,0,16,1,7.6,45,84.44,0,0,1,38,2011
SS Naik,INDIA,1974,1974,0,2,0,20,0,19.0,68,55.88,0,0,0,38,1974
Najeeb Amar,HKG,2004,2008,4,4,0,21,1,12.66,64,59.37,0,0,1,38,2004
GH O'Brien,BMUDA,2006,2008,2,7,0,16,0,5.42,54,70.37,0,0,2,38,2006
CAH Stevenson,USA,2019,2019,0,4,1,34,1,12.66,44,86.36,0,0,1,38,2019
S Walusimbi,EAf,1975,1975,0,3,0,16,0,12.66,126,30.15,0,0,0,38,1975
PN Webb,NZ,1983,1984,1,5,1,10,1,9.5,101,37.62,0,0,0,38,1983
Zeeshan Maqsood,OMAN,2019,2019,0,5,0,21,1,9.5,74,51.35,0,0,1,38,2019
JR Hazlewood,AUS,2010,2018,8,13,1,11,11,18.5,57,64.91,0,0,1,37,2010
MP Jarvis,ZIM,1987,1995,8,5,0,17,3,18.5,67,55.22,0,0,0,37,1987
TS Kamunhukamwe,ZIM,2018,2019,1,3,0,34,0,12.33,50,74.0,0,0,1,37,2018
TS Roland-Jones,ENG,2017,2017,0,1,1,37,1,0.0,37,100.0,0,0,0,37,2017
Saiful Islam,BDESH,1990,1997,7,4,1,22,2,18.5,59,62.71,0,0,0,37,1990
Shahid Anwar,PAK,1996,1996,0,1,0,37,0,37.0,44,84.09,0,0,0,37,1996
DJ White,NZ,1990,1990,0,3,0,15,0,12.33,97,38.14,0,0,0,37,1990
Ankur Vasishta,HKG,2014,2014,0,4,0,18,1,12.0,69,52.17,0,0,0,36,2014
M Bhanuka,SL,2019,2019,0,1,0,36,0,36.0,39,92.3,0,0,0,36,2019
PW Gunaratne,SL,2002,2003,1,8,1,15,3,7.2,63,57.14,0,0,2,36,2002
MF Malone,AUS,1977,1982,5,7,1,15,3,9.0,63,57.14,0,0,0,36,1977
G Mylvaganam,UAE,1996,1996,0,3,0,23,0,12.0,92,39.13,0,0,1,36,1996
AR Pitcher,BMUDA,2006,2007,1,4,0,30,0,9.0,89,40.44,0,0,0,36,2006
KR Pushpakumara,SL,1994,1999,5,9,1,14,5,9.0,52,69.23,0,0,2,36,1994
Saleem Jaffar,PAK,1986,1990,4,13,1,10,11,18.0,73,49.31,0,0,2,36,1986
RB Simpson,AUS,1978,1978,0,2,0,23,0,18.0,53,67.92,0,0,0,36,1978
LO Tikolo,KENYA,1996,1996,0,2,1,25,2,0.0,75,48.0,0,0,0,36,1996
JO Troughton,ENG,2003,2003,0,5,0,20,1,9.0,76,47.36,0,0,1,36,2003
B Bhandari,NEPAL,2019,2019,0,3,0,21,0,11.66,77,45.45,0,0,0,35,2019
PKD Chase,IRE,2015,2018,3,16,0,14,6,3.5,56,62.5,0,0,7,35,2015
H Durham,BMUDA,2006,2006,0,7,0,11,3,8.75,105,33.33,0,0,0,35,2006
G Dymock,AUS,1974,1980,6,7,1,14,4,11.66,82,42.68,0,0,1,35,1974
Joginder Sharma,INDIA,2004,2007,3,3,1,29,2,35.0,30,116.66,0,0,0,35,2004
C McAuslan,HKG,2017,2017,0,2,0,27,0,17.5,72,48.61,0,0,0,35,2017
Nazmul Hossain,BDESH,2004,2012,8,21,1,6,13,4.37,128,27.34,0,0,4,35,2004
JO Ngoche,KENYA,2010,2013,3,11,1,21,4,5.0,85,41.17,0,0,4,35,2010
KT Sandher,CAN,2006,2007,1,10,0,12,4,5.83,107,32.71,0,0,1,35,2006
AR Tait,NZ,1998,1999,1,5,1,13,2,11.66,32,109.37,0,0,0,35,1998
SD Udal,ENG,1994,2005,11,7,1,11,4,11.66,46,76.08,0,0,1,35,1994
MWA van Nierop,NL,2006,2006,0,2,1,31,1,35.0,49,71.42,0,0,0,35,2006
SM Warnapura,SL,2007,2008,1,3,0,30,0,11.66,76,46.05,0,0,1,35,2007
Zulfiqar Babar,PAK,2014,2015,1,5,1,14,3,17.5,40,87.5,0,0,0,35,2014
RP Alexander,USA,2004,2004,0,2,0,26,0,17.0,75,45.33,0,0,0,34,2004
SA Ankola,INDIA,1989,1997,8,13,0,9,4,3.77,42,80.95,0,0,5,34,1989
Ata-ur-Rehman,PAK,1992,1996,4,13,1,11,6,4.85,76,44.73,0,0,2,34,1992
Atiq-uz-Zaman,PAK,2000,2000,0,3,0,18,1,17.0,36,94.44,0,0,0,34,2000
ID Austin,ENG,1998,1999,1,6,1,11,1,6.8,49,69.38,0,0,0,34,1998
RO Collinge,NZ,1973,1978,5,9,0,9,3,5.66,62,54.83,0,0,1,34,1973
RMS Eranga,SL,2011,2016,5,11,1,12,8,11.33,64,53.12,0,0,1,34,2011
BN French,ENG,1985,1988,3,8,1,9,3,6.8,71,47.88,0,0,2,34,1985
AS Luseno,KENYA,2003,2010,7,9,1,16,7,17.0,50,68.0,0,0,1,34,2003
M Mbangwa,ZIM,1996,2002,6,13,0,11,6,4.85,56,60.71,0,0,2,34,1996
Mohammad Asif,PAK,2005,2010,5,16,0,6,7,3.77,100,34.0,0,0,3,34,2005
CG Rackemann,AUS,1983,1991,8,18,1,9,6,2.83,77,44.15,0,0,6,34,1983
TT Smart,HKG,2004,2004,0,2,0,25,0,17.0,94,36.17,0,0,0,34,2004
Fayyaz Butt,OMAN,2019,2019,0,3,1,32,1,16.5,42,78.57,0,0,1,33,2019
T Gibbons,BMUDA,2006,2006,0,2,0,33,0,16.5,98,33.67,0,0,1,33,2006
LWS Kaluperuma,SL,1975,1982,7,3,1,14,3,0.0,60,55.0,0,0,0,33,1975
RR Kulkarni,INDIA,1983,1987,4,5,0,15,3,16.5,39,84.61,0,0,0,33,1983
RJ McCurdy,AUS,1985,1985,0,6,1,13,2,8.25,71,46.47,0,0,1,33,1985
GE Peckover,ZIM,1983,1983,0,3,1,16,1,16.5,54,61.11,0,0,0,33,1983
PARP Perera,SL,2019,2019,0,2,0,33,0,16.5,58,56.89,0,0,1,33,2019
TL Seifert,NZ,2019,2019,0,2,0,22,0,16.5,27,122.22,0,0,0,33,2019
AS Wassan,INDIA,1990,1991,1,6,0,16,2,8.25,56,58.92,0,0,1,33,1990
TM Alderman,AUS,1981,1991,10,18,1,9,6,2.66,97,32.98,0,0,6,32,1981
RE Bryson,SA,1997,1997,0,4,1,17,3,32.0,25,128.0,0,0,0,32,1997
BFW de Leede,NL,2018,2019,1,3,0,30,0,10.66,75,42.66,0,0,1,32,2018
BP Kruger,NL,2010,2011,1,3,0,15,0,10.66,50,64.0,0,0,0,32,2010
SLV Raju,INDIA,1990,1996,6,16,0,8,8,4.0,67,47.76,0,0,4,32,1990
JD Siddons,AUS,1988,1988,0,1,0,32,0,32.0,37,86.48,0,0,0,32,1988
SP Terry,IRE,2016,2016,0,5,0,16,0,6.4,67,47.76,0,0,1,32,2016
Amir Hayat,UAE,2018,2019,1,6,1,24,3,10.33,73,42.46,0,0,1,31,2018
BS Bedi,INDIA,1974,1979,5,7,0,13,2,6.2,70,44.28,0,0,1,31,1974
HM Goonatilleke,SL,1982,1982,0,4,1,14,3,31.0,58,53.44,0,0,0,31,1982
PW Jarvis,ENG,1988,1993,5,8,1,16,2,5.16,39,79.48,0,0,2,31,1988
C Jonker,SA,2018,2018,0,2,0,25,0,15.5,33,93.93,0,0,0,31,2018
GC Martin,ZIM,1994,1995,1,4,0,16,0,7.75,65,47.69,0,0,0,31,1994
MN Nawaz,SL,1998,2002,4,3,1,15,1,15.5,71,43.66,0,0,0,31,1998
JD Nel,SCOT,2006,2010,4,10,1,11,8,15.5,54,57.4,0,0,1,31,2006
PADLR Sandakan,SL,2016,2019,3,12,0,6,4,3.87,88,35.22,0,0,2,31,2016
MM Sharma,INDIA,2013,2015,2,9,0,11,5,7.75,66,46.96,0,0,1,31,2013
PM Siddle,AUS,2009,2019,10,6,1,10,3,10.33,30,103.33,0,0,1,31,2009
Sikander Bakht,PAK,1977,1989,12,11,1,16,7,7.75,97,31.95,0,0,2,31,1977
RW Sims,ZIM,2002,2003,1,2,0,24,1,31.0,67,46.26,0,0,0,31,2002
HR Walsh,USA/WI,2019,2019,0,2,0,27,0,15.5,37,83.78,0,0,0,31,2019
RD Woolley,AUS,1983,1983,0,3,0,16,2,31.0,38,81.57,0,0,0,31,1983
M Yachad,SA,1991,1991,0,1,0,31,0,31.0,77,40.25,0,0,0,31,1991
BE Young,AUS,1998,1999,1,3,0,18,1,15.5,47,65.95,0,0,0,31,1998
GJ Batty,ENG,2002,2009,7,8,0,17,2,5.0,73,41.09,0,0,1,30,2002
SL Boock,NZ,1978,1987,9,7,0,12,4,10.0,31,96.77,0,0,1,30,1978
M Cheruparambil,HKG,2004,2004,0,2,0,30,0,15.0,52,57.69,0,0,1,30,2004
PT Collins,WI,1999,2005,6,12,1,10,5,4.28,50,60.0,0,0,2,30,1999
BL D'Oliveira,ENG,1971,1972,1,4,0,17,1,10.0,43,69.76,0,0,0,30,1971
Ehsan Nawaz,HKG,2014,2018,4,10,0,11,4,5.0,87,34.48,0,0,3,30,2014
MVT Fernando,SL,2017,2019,2,8,1,7,6,15.0,61,49.18,0,0,1,30,2017
EE Hemmings,ENG,1982,1991,9,12,1,8,6,5.0,61,49.18,0,0,1,30,1982
AJ Ireland,ZIM,2005,2007,2,13,1,8,5,3.75,101,29.7,0,0,3,30,2005
FJ Klaassen,NL,2018,2019,1,3,0,13,1,15.0,52,57.69,0,0,0,30,2018
IT Shillingford,WI,1978,1978,0,2,0,24,0,15.0,38,78.94,0,0,0,30,1978
PA van Meekeren,NL,2013,2019,6,3,1,15,3,0.0,40,75.0,0,0,0,30,2013
JCB Vaughan,CAN,1979,1979,0,3,0,29,0,10.0,55,54.54,0,0,1,30,1979
JS Ababu,KENYA,1999,2006,7,5,0,17,2,9.66,63,46.03,0,0,0,29,1999
N Pradeep,SL,2012,2019,7,21,0,7,14,4.14,77,37.66,0,0,4,29,2012
TCB Fernando,SL,2001,2003,2,10,1,14,6,7.25,59,49.15,0,0,1,29,2001
BW Hilfenhaus,AUS,2007,2012,5,11,0,16,8,9.66,69,42.02,0,0,0,29,2007
Imran Abbas,PAK,2000,2000,0,2,0,28,0,14.5,63,46.03,0,0,0,29,2000
DI Joyce,IRE,2006,2007,1,3,0,18,0,9.66,56,51.78,0,0,1,29,2006
ARM Opatha,SL,1975,1979,4,3,0,18,0,9.66,55,52.72,0,0,1,29,1975
KJ Wright,AUS,1979,1979,0,2,0,23,0,14.5,52,55.76,0,0,0,29,1979
Adeel Raja,NL,2002,2011,9,12,1,8,2,2.8,139,20.14,0,0,4,28,2002
WW Davis,WI,1983,1988,5,5,0,10,3,14.0,53,52.83,0,0,0,28,1983
JD Hall,IRE,2010,2010,0,3,0,15,0,9.33,75,37.33,0,0,0,28,2010
Kamran Hussain,PAK,2008,2008,0,1,1,28,1,0.0,21,133.33,0,0,0,28,2008
Mohammad Hasnain,PAK,2019,2019,0,2,0,28,0,14.0,18,155.55,0,0,1,28,2019
DS Mohanty,INDIA,1997,2001,4,11,1,18,6,5.6,57,49.12,0,0,3,28,1997
Taslim Arif,PAK,1980,1980,0,2,0,24,0,14.0,58,48.27,0,0,0,28,1980
Ehsan Adil,PAK,2013,2015,2,4,0,15,1,9.0,42,64.28,0,0,0,27,2013
TJ Franklin,NZ,1983,1988,5,3,0,21,0,9.0,89,30.33,0,0,1,27,1983
TG Gordon,CAN,2011,2011,0,5,0,9,0,5.4,59,45.76,0,0,0,27,2011
TJ Heggelman,NL,2010,2011,1,5,0,22,0,5.4,85,31.76,0,0,0,27,2010
HAPW Jayawardene,SL,2003,2007,4,5,0,20,0,5.4,44,61.36,0,0,1,27,2003
TP Kamungozi,ZIM,2006,2015,9,11,1,12,6,5.4,55,49.09,0,0,2,27,2006
BL Kotze,NAM,2003,2003,0,4,1,24,1,9.0,51,52.94,0,0,2,27,2003
DS Kulkarni,INDIA,2014,2016,2,2,1,25,2,0.0,28,96.42,0,0,0,27,2014
WM Lawry,AUS,1971,1971,0,1,0,27,0,27.0,49,55.1,0,0,0,27,1971
Mohsin Kamal,PAK,1984,1989,5,6,1,11,3,9.0,40,67.5,0,0,0,27,1984
Mujahid Jamshed,PAK,1997,1997,0,3,0,23,1,13.5,54,50.0,0,0,0,27,1997
RJ Robinson,BMUDA,2007,2009,2,2,0,17,0,13.5,40,67.5,0,0,0,27,2007
Rumman Raees,PAK,2017,2018,1,4,0,16,1,9.0,24,112.5,0,0,1,27,2017
ED Solkar,INDIA,1974,1976,2,6,0,13,0,4.5,79,34.17,0,0,1,27,1974
BA Williams,AUS,2002,2004,2,6,1,13,4,13.5,46,58.69,0,0,2,27,2002
Zakir Khan,PAK,1984,1990,6,5,1,11,4,27.0,63,42.85,0,0,0,27,1984
Aizaz Cheema,PAK,2011,2012,1,6,1,9,3,8.66,45,57.77,0,0,0,26,2011
BJ Diamanti,NZ,2009,2009,0,1,1,26,1,0.0,22,118.18,0,0,0,26,2009
BG Hadlee,NZ,1975,1975,0,2,0,19,1,26.0,93,27.95,0,0,0,26,1975
RC Haynes,WI,1989,1991,2,6,0,18,1,5.2,66,39.39,0,0,2,26,1989
Khurram Nawaz,OMAN,2019,2019,0,2,1,17,1,26.0,49,53.06,0,0,0,26,2019
A Kuruvilla,INDIA,1997,1997,0,11,0,7,4,3.71,43,60.46,0,0,1,26,1997
Mosharraf Hossain,BDESH,2008,2016,8,5,0,8,1,6.5,75,34.66,0,0,0,26,2008
MS Panesar,ENG,2007,2007,0,8,0,13,3,5.2,91,28.57,0,0,0,26,2007
Pervez Mir,PAK,1975,1977,2,3,0,18,1,13.0,44,59.09,0,0,0,26,1975
CEB Rice,SA,1991,1991,0,2,0,14,0,13.0,37,70.27,0,0,0,26,1991
TG Shaw,SA,1991,1994,3,6,1,17,4,13.0,35,74.28,0,0,1,26,1991
SL Stewart,NZ,2010,2010,0,4,0,14,0,6.5,59,44.06,0,0,0,26,2010
Tareq Aziz,BDESH,2002,2004,2,8,1,11,7,26.0,73,35.61,0,0,1,26,2002
BO van Rooi,NAM,2003,2003,0,3,0,17,2,26.0,38,68.42,0,0,0,26,2003
RJ van Vuuren,NAM,2003,2003,0,5,0,14,2,8.66,38,68.42,0,0,2,26,2003
Wasim Haider,PAK,1992,1992,0,2,0,13,0,13.0,70,37.14,0,0,0,26,1992
Zain Abbas,HKG,2008,2008,0,1,1,26,1,0.0,54,48.14,0,0,0,26,2008
Sultan Zarawani,UAE,1994,1996,2,6,0,13,0,4.33,62,41.93,0,0,1,26,1994
RJ Blakey,ENG,1992,1993,1,2,0,25,0,12.5,50,50.0,0,0,1,25,1992
DK Butler,WI,2005,2006,1,4,1,13,3,25.0,34,73.52,0,0,0,25,2005
JJ Dawood,CAN,2009,2010,1,1,1,25,1,0.0,19,131.57,0,0,0,25,2009
MLC Foster,WI,1973,1973,0,1,0,25,0,25.0,62,40.32,0,0,0,25,1973
S Jeganathan,SL,1983,1988,5,4,1,20,1,8.33,39,64.1,0,0,0,25,1983
KA Maharaj,SA,2017,2018,1,2,0,17,0,12.5,26,96.15,0,0,0,25,2017
GMC Mol,NL,2007,2008,1,4,0,14,2,12.5,54,46.29,0,0,0,25,2007
Nasir Ahmed,BDESH,1988,1990,2,4,0,11,2,12.5,62,40.32,0,0,0,25,1988
A Patel,CAN,2003,2003,0,1,0,25,0,25.0,29,86.2,0,0,0,25,2003
AK Sah,NEPAL,2018,2018,0,2,0,21,0,12.5,35,71.42,0,0,0,25,2018
Saleem Altaf,PAK,1973,1978,5,2,0,21,1,25.0,53,47.16,0,0,0,25,1973
Sayed Shirzad,AFG,2019,2019,0,1,0,25,0,25.0,17,147.05,0,0,0,25,2019
Shahid Nazir,PAK,1996,2000,4,8,0,8,7,25.0,43,58.13,0,0,0,25,1996
Sohail Khan,PAK,2008,2016,8,6,0,7,1,5.0,51,49.01,0,0,0,25,2008
SW Tait,AUS,2007,2011,4,7,0,11,5,12.5,29,86.2,0,0,1,25,2007
SK Atai,PNG,2019,2019,0,1,0,24,0,24.0,57,42.1,0,0,0,24,2019
MR Benson,ENG,1986,1986,0,1,0,24,0,24.0,58,41.37,0,0,0,24,1986
AN French,HKG,2004,2004,0,2,0,14,0,12.0,84,28.57,0,0,0,24,2004
ST Gabriel,WI,2016,2019,3,16,1,12,9,3.42,63,38.09,0,0,4,24,2016
SF Graf,AUS,1980,1981,1,6,0,8,0,4.0,50,48.0,0,0,1,24,1980
JPR Lamsam,HKG,2004,2008,4,2,0,16,0,12.0,47,51.06,0,0,0,24,2004
SW Lubbers,NL,1996,1996,0,4,0,9,1,8.0,37,64.86,0,0,0,24,1996
DJ Malan,ENG,2019,2019,0,1,0,24,0,24.0,30,80.0,0,0,0,24,2019
MJ Mason,NZ,2003,2010,7,7,1,13,4,8.0,45,53.33,0,0,1,24,2003
Naeem Ashraf,PAK,1995,1995,0,2,0,16,1,24.0,43,55.81,0,0,0,24,1995
SB O'Connor,NZ,1997,2000,3,13,0,8,6,3.42,91,26.37,0,0,3,24,1997
SP Pasqual,SL,1979,1979,0,2,1,23,1,24.0,28,85.71,0,0,0,24,1979
N Pothas,SA,2000,2000,0,1,0,24,0,24.0,41,58.53,0,0,0,24,2000
Rafiqul Alam,BDESH,1986,1986,0,2,0,14,0,12.0,63,38.09,0,0,0,24,1986
Sheikh Salahuddin,BDESH,1997,1997,0,5,0,12,3,12.0,136,17.64,0,0,0,24,1997
ML Su'a,NZ,1992,1995,3,7,1,12,2,4.8,56,42.85,0,0,0,24,1992
Amir Hamza,AFG,2012,2017,5,16,0,7,9,3.28,94,24.46,0,0,1,23,2012
JO Angara,KENYA,1997,2003,6,11,0,6,5,3.83,64,35.93,0,0,1,23,1997
HAG Anthony,WI,1995,1995,0,3,0,21,0,7.66,22,104.54,0,0,1,23,1995
Asim Butt,SCOT,1999,1999,0,4,0,11,0,5.75,28,82.14,0,0,0,23,1999
SV Bahutule,INDIA,1997,2003,6,4,0,11,1,7.66,29,79.31,0,0,0,23,1997
J Figy John,UAE,2019,2019,0,1,0,23,0,23.0,36,63.88,0,0,0,23,2019
SC Getkate,IRE,2019,2019,0,2,1,16,1,23.0,23,100.0,0,0,0,23,2019
AE Greenidge,WI,1978,1978,0,1,0,23,0,23.0,33,69.69,0,0,0,23,1978
Hasti Gul,AFG,2009,2009,0,1,1,23,1,0.0,11,209.09,0,0,0,23,2009
E Katchay,CAN,2008,2009,1,3,0,12,1,11.5,41,56.09,0,0,0,23,2008
J Louw,SA,2008,2008,0,1,0,23,0,23.0,7,328.57,0,0,0,23,2008
SJ Massiah,USA,2004,2004,0,2,0,23,0,11.5,44,52.27,0,0,1,23,2004
AJ Penn,NZ,1997,2001,4,3,0,15,1,11.5,33,69.69,0,0,0,23,1997
V Razdan,INDIA,1989,1990,1,3,0,18,1,11.5,27,85.18,0,0,0,23,1989
CP Tremain,AUS,2016,2016,0,3,1,23,2,23.0,37,62.16,0,0,1,23,2016
Waheed Ahmed,UAE,2019,2019,0,2,0,17,0,11.5,51,45.09,0,0,0,23,2019
Afzaal Haider,HKG,2004,2008,4,4,0,22,1,7.33,52,42.3,0,0,2,22,2004
UNK Fernando,SL,1994,1994,0,2,1,20,2,0.0,25,88.0,0,0,0,22,1994
DW Headley,ENG,1996,1999,3,6,1,10,4,11.0,49,44.89,0,0,1,22,1996
Kamran Shazad,UAE,2014,2015,1,3,0,13,1,11.0,25,88.0,0,0,1,22,2014
Mohammad Salman,PAK,2011,2011,0,3,1,19,1,11.0,39,56.41,0,0,1,22,2011
Shafiuddin Ahmed,BDESH,1997,2000,3,10,0,11,6,5.5,66,33.33,0,0,3,22,1997
BR Taylor,NZ,1973,1973,0,1,0,22,0,22.0,42,52.38,0,0,0,22,1973
CM Wells,ENG,1985,1985,0,2,0,17,0,11.0,44,50.0,0,0,0,22,1985
Ali Asad,UAE,2004,2004,0,2,0,12,1,21.0,47,44.68,0,0,0,21,2004
B Arun,INDIA,1986,1987,1,3,0,8,1,10.5,32,65.62,0,0,0,21,1986
AB Dinda,INDIA,2010,2013,3,5,0,16,0,4.2,36,58.33,0,0,2,21,2010
Karan KC,NEPAL,2018,2019,1,4,0,18,0,5.25,23,91.3,0,0,2,21,2018
S Keshvani,CAN,2009,2009,0,2,0,17,0,10.5,38,55.26,0,0,0,21,2009
MAWR Madurasinghe,SL,1988,1992,4,6,1,8,4,10.5,62,33.87,0,0,0,21,1988
J Patraj,CAN,2007,2007,0,2,0,20,0,10.5,48,43.75,0,0,0,21,2007
K Pierre,WI,2019,2019,0,1,0,21,0,21.0,18,116.66,0,0,0,21,2019
DA Stirling,NZ,1984,1984,0,5,1,13,2,7.0,39,53.84,0,0,0,21,1984
I Wardlaw,SCOT,2013,2015,2,14,1,7,8,3.5,40,52.5,0,0,5,21,2013
RA Woolmer,ENG,1972,1976,4,4,0,9,0,5.25,46,45.65,0,0,1,21,1972
SP Davis,AUS,1986,1988,2,11,0,6,7,5.0,34,58.82,0,0,1,20,1986
O Henry,SA,1992,1992,0,3,0,11,1,10.0,26,76.92,0,0,0,20,1992
AP Igglesden,ENG,1994,1994,0,3,0,18,1,10.0,31,64.51,0,0,1,20,1994
MR Johnson,USA,2004,2004,0,2,0,20,0,10.0,19,105.26,0,0,1,20,2004
MMA Jonkman,NL,2007,2010,3,2,0,13,0,10.0,51,39.21,0,0,0,20,2007
BM Mauricette,CAN,1979,1979,0,3,0,15,0,6.66,68,29.41,0,0,1,20,1979
DT Mutendera,ZIM,1999,2001,2,4,0,10,2,10.0,43,46.51,0,0,0,20,1999
Najmul Hossain Shanto,BDESH,2018,2018,0,3,0,7,0,6.66,45,44.44,0,0,0,20,2018
IL Philip,SCOT,1999,1999,0,3,0,17,0,6.66,89,22.47,0,0,1,20,1999
ADJ Pitcher,BMUDA,2007,2007,0,3,0,12,0,6.66,28,71.42,0,0,1,20,2007
Rizwan-uz-Zaman,PAK,1981,1987,6,3,0,14,0,6.66,129,15.5,0,0,0,20,1981
AF Sattaur,CAN,2003,2003,0,3,0,13,0,6.66,60,33.33,0,0,1,20,2003
PH Sharma,INDIA,1976,1976,0,2,0,14,0,10.0,39,51.28,0,0,0,20,1976
S Shivnarine,WI,1978,1978,0,1,1,20,1,0.0,43,46.51,0,0,0,20,1978
Umair Ali,UAE,2015,2015,0,2,0,10,0,10.0,30,66.66,0,0,0,20,2015
KIW Wijegunawardene,SL,1988,1992,4,12,1,8,5,2.85,55,36.36,0,0,4,20,1988
CA Young,IRE,2014,2017,3,6,1,11,2,5.0,32,62.5,0,0,2,20,2014
JP Behrendorff,AUS,2019,2019,0,5,1,11,3,9.5,15,126.66,0,0,1,19,2019
JJ Bumrah,INDIA,2016,2019,3,13,1,10,8,3.8,43,44.18,0,0,4,19,2016
JW Dernbach,ENG,2011,2013,2,8,0,5,1,2.71,39,48.71,0,0,1,19,2011
EL Gouka,NL,1996,1996,0,2,0,19,1,19.0,36,52.77,0,0,0,19,1996
RGA Headley,WI,1973,1973,0,1,0,19,0,19.0,41,46.34,0,0,0,19,1973
S Jora,NEPAL,2019,2019,0,1,0,19,0,19.0,20,95.0,0,0,0,19,2019
T Kumaran,INDIA,1999,2000,1,3,0,8,0,6.33,27,70.37,0,0,0,19,1999
MA Meman,ZIM,1987,1987,0,1,0,19,0,19.0,22,86.36,0,0,0,19,1987
V Permaul,WI,2012,2017,5,4,0,10,1,6.33,26,73.07,0,0,0,19,2012
HSM Pieris,SL,1975,1975,0,3,0,16,1,9.5,59,32.2,0,0,0,19,1975
Sami Faridi,CAN,2008,2008,0,2,0,16,0,9.5,31,61.29,0,0,0,19,2008
MJ Smith,SCOT,1999,1999,0,5,0,13,0,3.8,85,22.35,0,0,0,19,1999
Sunzamul Islam,BDESH,2017,2018,1,1,0,19,0,19.0,24,79.16,0,0,0,19,2017
C Viljoen,NAM,2019,2019,0,2,1,17,1,19.0,23,82.6,0,0,0,19,2019
AG Wharf,ENG,2004,2005,1,5,0,9,3,9.5,28,67.85,0,0,1,19,2004
KOK Williams,WI,2017,2018,1,5,1,16,4,19.0,27,70.37,0,0,0,19,2017
SG Borthwick,ENG,2011,2011,0,2,0,15,0,9.0,16,112.5,0,0,0,18,2011
DL Chahar,INDIA,2018,2019,1,2,0,12,1,18.0,22,81.81,0,0,0,18,2018
CEH Croft,WI,1977,1981,4,6,0,8,4,9.0,38,47.36,0,0,0,18,1977
HJ Howarth,NZ,1973,1975,2,5,0,11,2,6.0,26,69.23,0,0,1,18,1973
Jamaluddin Ahmed,BDESH,2003,2003,0,1,1,18,1,0.0,28,64.28,0,0,0,18,2003
F Kasteni,ZIM,2007,2007,0,3,0,9,0,6.0,42,42.85,0,0,1,18,2007
AV Lalcheta,OMAN,2019,2019,0,2,0,12,0,9.0,47,38.29,0,0,0,18,2019
JJC Lawson,WI,2001,2005,4,5,0,8,2,6.0,16,112.5,0,0,0,18,2001
Munir Dar,HKG,2008,2008,0,2,0,14,0,9.0,16,112.5,0,0,0,18,2008
Saleem Pervez,PAK,1980,1980,0,1,0,18,0,18.0,39,46.15,0,0,0,18,1980
LR Shukla,INDIA,1999,1999,0,2,0,13,0,9.0,19,94.73,0,0,0,18,1999
Sultan Ahmed,UAE,2019,2019,0,2,0,11,0,9.0,42,42.85,0,0,0,18,2019
Syed Maqsood,UAE,2004,2004,0,2,0,13,0,9.0,43,41.86,0,0,0,18,2004
Tanvir Ahmed,PAK,2011,2011,0,1,0,18,0,18.0,12,150.0,0,0,0,18,2011
K Whatham,CAN,2011,2011,0,1,0,18,0,18.0,41,43.9,0,0,0,18,2011
RGCE Wijesuriya,SL,1982,1985,3,3,1,12,2,18.0,48,37.5,0,0,1,18,1982
Zulqarnain,PAK,1985,1989,4,6,1,11,3,6.0,30,60.0,0,0,2,18,1985
GI Allott,NZ,1997,2000,3,11,1,7,6,3.4,56,30.35,0,0,2,17,1997
SM Curran,ENG,2018,2018,0,2,0,15,0,8.5,29,58.62,0,0,0,17,2018
IS Gallage,SL,1999,2001,2,2,0,14,1,17.0,27,62.96,0,0,0,17,1999
RD Gudhka,KENYA,2011,2011,0,2,0,10,1,17.0,14,121.42,0,0,0,17,2011
MJ Hoggard,ENG,2001,2006,5,6,0,7,2,4.25,30,56.66,0,0,1,17,2001
Ilyas Gull,HKG,2004,2004,0,2,0,16,0,8.5,59,28.81,0,0,0,17,2004
Intikhab Alam,PAK,1973,1976,3,2,0,10,0,8.5,45,37.77,0,0,0,17,1973
IT Iqbal,KENYA,1996,1996,0,2,0,16,0,8.5,52,32.69,0,0,0,17,1996
RSA Jayasekera,SL,1982,1982,0,1,0,17,0,17.0,42,40.47,0,0,0,17,1982
KCB Jeremy,WI,2000,2001,1,4,1,8,2,8.5,42,40.47,0,0,1,17,2000
RJ Kennedy,NZ,1996,1996,0,4,1,8,3,17.0,15,113.33,0,0,0,17,1996
CBRLS Kumara,SL,2017,2019,2,6,1,7,3,5.66,45,37.77,0,0,0,17,2017
P Lever,ENG,1971,1975,4,3,1,8,2,17.0,24,70.83,0,0,0,17,1971
PHKD Mendis,SL,2019,2019,0,2,0,9,1,17.0,38,44.73,0,0,0,17,2019
Raqibul Hasan,BDESH,1986,1986,0,2,0,12,0,8.5,65,26.15,0,0,0,17,1986
CEW Silverwood,ENG,1996,2001,5,4,0,12,0,4.25,34,50.0,0,0,1,17,1996
S Abrahams,SA,2000,2000,0,1,1,16,1,0.0,26,61.53,0,0,0,16,2000
RW Anderson,NZ,1976,1978,2,2,0,12,1,16.0,46,34.78,0,0,0,16,1976
JH Desai,USA,2004,2004,0,1,0,16,0,16.0,38,42.1,0,0,0,16,2004
AM Guruge,UAE,2014,2015,1,4,1,10,4,0.0,29,55.17,0,0,0,16,2014
N Ifill,CAN,2003,2006,3,3,0,9,0,5.33,45,35.55,0,0,1,16,2003
Jahangir Shah,BDESH,1986,1990,4,4,1,8,2,8.0,62,25.8,0,0,1,16,1986
RL Johnson,ENG,2003,2003,0,4,0,10,1,5.33,20,80.0,0,0,1,16,2003
SB Lama,HKG,2004,2004,0,1,1,16,1,0.0,48,33.33,0,0,0,16,2004
BP Loots,NL,2010,2011,1,5,1,9,2,5.33,27,59.25,0,0,1,16,2010
RAL Massie,AUS,1972,1972,0,1,1,16,1,0.0,24,66.66,0,0,0,16,1972
B Muzarabani,ZIM,2018,2018,0,15,0,7,7,2.0,89,17.97,0,0,5,16,2018
KJ O'Keeffe,AUS,1977,1977,0,2,1,16,1,16.0,38,42.1,0,0,1,16,1977
FN Otieno,KENYA,2010,2010,0,4,0,8,0,4.0,68,23.52,0,0,1,16,2010
ADG Roberts,NZ,1976,1976,0,1,0,16,0,16.0,24,66.66,0,0,0,16,1976
V Shetty,UAE,2008,2014,6,2,0,9,0,8.0,29,55.17,0,0,0,16,2008
Shubman Gill,INDIA,2019,2019,0,2,0,9,0,8.0,32,50.0,0,0,0,16,2019
CB Sole,SCOT,2016,2018,2,5,0,7,0,3.2,36,44.44,0,0,0,16,2016
S Somasunder,INDIA,1996,1996,0,2,0,9,0,8.0,63,25.39,0,0,0,16,1996
J Theron,SA/USA,2010,2019,9,6,0,6,1,3.2,30,53.33,0,0,2,16,2010
BTJ Wheal,SCOT,2016,2019,3,7,0,14,3,4.0,31,51.61,0,0,3,16,2016
PJW Allott,ENG,1982,1985,3,6,0,8,1,3.0,25,60.0,0,0,2,15,1982
KN Amalean,SL,1986,1988,2,3,0,9,1,7.5,26,57.69,0,0,0,15,1986
RR Beaton,WI,2017,2017,0,2,1,12,1,15.0,51,29.41,0,0,0,15,2017
HF Gurney,ENG,2014,2014,0,6,1,6,4,7.5,33,45.45,0,0,0,15,2014
JR Hammond,AUS,1972,1972,0,1,1,15,1,0.0,28,53.57,0,0,0,15,1972
RS Higgins,ZIM,2006,2006,0,8,1,7,2,2.5,63,23.8,0,0,3,15,2006
DAW Hollis,BMUDA,2008,2008,0,1,1,15,1,0.0,26,57.69,0,0,0,15,2008
Irfan Fazil,PAK,2000,2000,0,1,0,15,0,15.0,16,93.75,0,0,0,15,2000
GE Kidd,IRE,2007,2008,1,1,0,15,0,15.0,25,60.0,0,0,0,15,2007
BW Luckhurst,ENG,1975,1975,0,3,0,14,0,5.0,69,21.73,0,0,1,15,1975
Mansoor Rana,PAK,1990,1990,0,2,0,10,0,7.5,24,62.5,0,0,0,15,1990
Mohammad Zahid,PAK,1996,2002,6,4,1,7,2,7.5,22,68.18,0,0,0,15,1996
J Mulder,IRE,2017,2017,0,2,1,15,2,0.0,11,136.36,0,0,0,15,2017
EMDY Munaweera,SL,2017,2017,0,2,0,11,0,7.5,29,51.72,0,0,0,15,2017
Nurul Abedin,BDESH,1986,1990,4,4,0,13,0,3.75,55,27.27,0,0,2,15,1986
HD Rutherford,NZ,2013,2013,0,4,0,11,0,3.75,56,26.78,0,0,0,15,2013
Sajjad Ahmed,BDESH,1995,1995,0,2,0,11,0,7.5,46,32.6,0,0,0,15,1995
DM Smith,ENG,1986,1990,4,2,1,10,1,15.0,40,37.5,0,0,0,15,1986
LW Stokkers,NL,2008,2008,0,1,1,15,1,0.0,40,37.5,0,0,0,15,2008
Tariq Javed,CAN,1979,1979,0,3,0,8,0,5.0,77,19.48,0,0,0,15,1979
PCR Tufnell,ENG,1990,1997,7,10,1,5,9,15.0,31,48.38,0,0,0,15,1990
PS Vaidya,INDIA,1995,1996,1,2,0,12,0,7.5,12,125.0,0,0,0,15,1995
A van der Merwe,IRE,2010,2011,1,6,0,8,2,3.75,25,60.0,0,0,2,15,2010
AP Wells,ENG,1995,1995,0,1,0,15,0,15.0,10,150.0,0,0,0,15,1995
Zafar Gohar,PAK,2015,2015,0,1,0,15,0,15.0,15,100.0,0,0,0,15,2015
Ahsan Malik,NL,2011,2014,3,5,1,10,5,0.0,27,51.85,0,0,0,14,2011
Asghar Ali,UAE,2004,2004,0,2,0,14,0,7.0,53,26.41,0,0,1,14,2004
Asif Mahmood,PAK,1998,1998,0,2,0,14,0,7.0,34,41.17,0,0,1,14,1998
IPP Batuwitarachchi,UAE,2008,2008,0,2,0,14,0,7.0,48,29.16,0,0,1,14,2008
AR Butcher,ENG,1980,1980,0,1,0,14,0,14.0,26,53.84,0,0,0,14,1980
G Chapple,ENG,2006,2006,0,1,0,14,0,14.0,7,200.0,0,0,0,14,2006
LA Dawson,ENG,2016,2018,2,2,0,10,0,7.0,17,82.35,0,0,0,14,2016
HS Dhillon,CAN,2006,2006,0,2,0,13,0,7.0,35,40.0,0,0,0,14,2006
EA Essop-Adam,ZIM,1992,1992,0,1,1,14,1,0.0,15,93.33,0,0,0,14,1992
SKW Kelly,BMUDA,2006,2009,3,6,1,7,6,0.0,31,45.16,0,0,0,14,2006
LD Madushanka,SL,2017,2017,0,4,0,7,1,4.66,26,53.84,0,0,1,14,2017
AA Mallett,AUS,1971,1975,4,3,0,8,1,7.0,36,38.88,0,0,1,14,1971
Mohammad Akram,PAK,1995,2000,5,9,1,7,7,7.0,34,41.17,0,0,1,14,1995
Nadeem Ghauri,PAK,1990,1990,0,3,1,7,2,14.0,25,56.0,0,0,0,14,1990
R Ngarava,ZIM,2017,2018,1,6,0,10,1,2.8,30,46.66,0,0,2,14,2017
IA Nicolson,ZIM,2010,2010,0,2,0,14,0,7.0,22,63.63,0,0,1,14,2010
D Soraine,CAN,2006,2012,6,4,0,6,0,3.5,20,70.0,0,0,1,14,2006
GE Vivian,NZ,1973,1973,0,1,0,14,0,14.0,30,46.66,0,0,0,14,1973
LJ Woodcock,NZ,2011,2011,0,2,0,11,1,14.0,22,63.63,0,0,0,14,2011
Zahid Razzak,BDESH,1988,1990,2,3,0,6,0,4.66,44,31.81,0,0,0,14,1988
Aamer Nazir,PAK,1993,1995,2,3,1,9,2,13.0,20,65.0,0,0,0,13,1993
Aamir Kaleem,OMAN,2019,2019,0,1,0,13,0,13.0,16,81.25,0,0,0,13,2019
JC Archer,ENG,2019,2019,0,7,1,7,3,3.25,22,59.09,0,0,1,13,2019
Asad Ali,PAK,2013,2013,0,2,0,11,0,6.5,16,81.25,0,0,0,13,2013
LS Baker,WI,2008,2009,1,4,1,11,2,6.5,23,56.52,0,0,1,13,2008
MD Bates,NZ,2012,2012,0,1,0,13,0,13.0,10,130.0,0,0,0,13,2012
GA Bishop,AUS,1987,1987,0,2,0,7,0,6.5,44,29.54,0,0,0,13,1987
GK Bose,INDIA,1974,1974,0,1,0,13,0,13.0,18,72.22,0,0,0,13,1974
NG Cowans,ENG,1983,1985,2,8,1,4,3,2.6,29,44.82,0,0,3,13,1983
HT Davis,NZ,1994,1997,3,6,1,7,4,6.5,33,39.39,0,0,1,13,1994
RR Emrit,WI,2007,2007,0,2,0,13,1,13.0,35,37.14,0,0,0,13,2007
Gurkeerat Singh,INDIA,2016,2016,0,3,0,8,1,6.5,13,100.0,0,0,0,13,2016
RL Hayes,NZ,1995,1995,0,1,0,13,0,13.0,25,52.0,0,0,0,13,1995
RO Hurley,WI,2003,2004,1,4,0,6,0,3.25,32,40.62,0,0,1,13,2003
D Joseph,CAN,2003,2003,0,3,1,9,3,0.0,24,54.16,0,0,0,13,2003
JJ Krejza,AUS,2011,2011,0,2,0,7,1,13.0,23,56.52,0,0,0,13,2011
AMN Munasinghe,SL,1994,1996,2,4,0,8,1,4.33,52,25.0,0,0,1,13,1994
B Regmi,NEPAL,2018,2019,1,4,0,12,0,3.25,47,27.65,0,0,2,13,2018
S Seeraj,CAN,2006,2006,0,1,1,13,1,0.0,12,108.33,0,0,0,13,2006
O Thomas,WI,2018,2019,1,10,1,6,5,2.6,53,24.52,0,0,3,13,2018
Usman Salahuddin,PAK,2011,2011,0,2,0,8,0,6.5,28,46.42,0,0,0,13,2011
HN Ya France,NAM,2019,2019,0,2,1,11,1,13.0,5,260.0,0,0,0,13,2019
Zaheer Maqsood,UAE,2015,2015,0,2,1,8,2,0.0,46,28.26,0,0,0,13,2015
Asim Saeed,UAE,2004,2004,0,2,0,12,0,6.0,19,63.15,0,0,1,12,2004
DM Basden,BMUDA,2007,2007,0,2,0,7,0,6.0,39,30.76,0,0,0,12,2007
GK Bruk-Jackson,ZIM,1993,1993,0,1,0,12,0,12.0,33,36.36,0,0,0,12,1993
Danish Kaneria,PAK,2001,2007,6,10,1,6,8,6.0,22,54.54,0,0,2,12,2001
IC Davis,AUS,1974,1977,3,3,1,11,1,6.0,35,34.28,0,0,1,12,1974
RP de Groen,NZ,1993,1994,1,8,1,7,3,2.4,36,33.33,0,0,4,12,1993
AM de Silva,SL,1986,1993,7,2,0,8,0,6.0,24,50.0,0,0,0,12,1986
R Dhawan,INDIA,2016,2016,0,2,0,9,1,12.0,13,92.3,0,0,0,12,2016
Enamul Haque jnr,BDESH,2005,2009,4,5,0,5,1,3.0,19,63.15,0,0,2,12,2005
M Hayward,SA,1998,2002,4,5,0,4,1,3.0,28,42.85,0,0,1,12,1998
Imtiaz Abbasi,UAE,1994,1996,2,6,1,6,4,6.0,38,31.57,0,0,0,12,1994
Javed Qadeer,PAK,1995,1995,0,1,0,12,0,12.0,23,52.17,0,0,0,12,1995
TJ Jenner,AUS,1975,1975,0,1,0,12,0,12.0,25,48.0,0,0,0,12,1975
AJ McKay,NZ,2010,2012,2,10,1,4,7,4.0,47,25.53,0,0,3,12,2010
PS Mehta,EAf,1975,1975,0,1,0,12,0,12.0,41,29.26,0,0,0,12,1975
PJK Mooney,IRE,2006,2007,1,3,1,11,2,12.0,9,133.33,0,0,1,12,2006
T Muzarabani,ZIM,2015,2016,1,7,0,5,3,3.0,40,30.0,0,0,1,12,2015
Naeemuddin Aslam,UAE,2004,2004,0,2,0,12,0,6.0,31,38.7,0,0,1,12,2004
TS Nethula,NZ,2012,2012,0,3,1,9,1,6.0,11,109.09,0,0,1,12,2012
Noor-ul-Haq,AFG,2010,2010,0,2,0,12,0,6.0,58,20.68,0,0,1,12,2010
EJ Richardson,IRE,2013,2013,0,1,0,12,0,12.0,18,66.66,0,0,0,12,2013
P Sarraf,NEPAL,2019,2019,0,2,0,8,0,6.0,18,66.66,0,0,0,12,2019
S Snater,NL,2018,2018,0,2,0,12,0,6.0,14,85.71,0,0,1,12,2018
Abul Hasan,BDESH,2012,2018,6,3,0,7,0,3.66,16,68.75,0,0,0,11,2012
Ahmed Kamal,BDESH,1999,1999,0,1,0,11,0,11.0,19,57.89,0,0,0,11,1999
MJD Allingham,SCOT,1999,1999,0,3,0,6,0,3.66,96,11.45,0,0,0,11,1999
Arshad Pervez,PAK,1978,1978,0,2,0,8,0,5.5,47,23.4,0,0,0,11,1978
J Blackwood,WI,2015,2015,0,2,0,9,0,5.5,23,47.82,0,0,0,11,2015
LJ Burger,NAM,2003,2003,0,6,0,5,1,2.2,62,17.74,0,0,2,11,2003
SF Burger,NAM,2003,2003,0,2,0,6,0,5.5,20,55.0,0,0,0,11,2003
PH Carlson,AUS,1979,1979,0,2,0,11,0,5.5,30,36.66,0,0,1,11,1979
BS Chandrasekhar,INDIA,1976,1976,0,1,1,11,1,0.0,13,84.61,0,0,0,11,1976
PA Emery,AUS,1994,1994,0,1,1,11,1,0.0,13,84.61,0,0,0,11,1994
Haafiz Shahid,PAK,1988,1988,0,3,1,7,2,11.0,23,47.82,0,0,0,11,1988
GW Humpage,ENG,1981,1981,0,2,0,6,0,5.5,24,45.83,0,0,0,11,1981
Jasdeep Singh,USA,2019,2019,0,3,0,11,0,3.66,39,28.2,0,0,2,11,2019
NGRP Jayasuriya,SL,2018,2018,0,2,1,11,1,11.0,13,84.61,0,0,1,11,2018
SMS Kaluperuma,SL,1988,1988,0,2,0,7,0,5.5,41,26.82,0,0,0,11,1988
SC Kuggeleijn,NZ,2017,2017,0,1,1,11,1,0.0,6,183.33,0,0,0,11,2017
NM Kulkarni,INDIA,1997,1998,1,5,1,5,3,5.5,20,55.0,0,0,1,11,1997
JA Maclean,AUS,1979,1979,0,1,0,11,0,11.0,33,33.33,0,0,0,11,1979
PM Pushpakumara,SL,2017,2017,0,2,0,8,0,5.5,26,42.3,0,0,0,11,2017
B Reddy,INDIA,1978,1981,3,2,1,8,2,0.0,20,55.0,0,0,0,11,1978
Saad Ali,PAK,2019,2019,0,2,0,7,0,5.5,23,47.82,0,0,0,11,2019
G Sharma,INDIA,1985,1987,2,2,0,7,0,5.5,24,45.83,0,0,0,11,1985
R Sharma,HKG,2004,2004,0,2,0,10,0,5.5,24,45.83,0,0,0,11,2004
FJ Titmus,ENG,1975,1975,0,1,0,11,0,11.0,32,34.37,0,0,0,11,1975
GD Watson,AUS,1972,1972,0,2,1,11,1,11.0,16,68.75,0,0,1,11,1972
JG Williamson,SCOT,1999,1999,0,2,0,10,0,5.5,35,31.42,0,0,0,11,1999
Zahid Shah,UAE,2008,2008,0,2,1,6,2,0.0,20,55.0,0,0,0,11,2008
TR Ambrose,ENG,2008,2008,0,5,0,6,1,2.5,34,29.41,0,0,1,10,2008
MA Aponso,SL,2016,2018,2,7,0,4,4,3.33,45,22.22,0,0,1,10,2016
Asif Masood,PAK,1973,1976,3,3,0,6,1,5.0,17,58.82,0,0,1,10,1973
HK Bennett,NZ,2010,2017,7,7,1,4,5,5.0,35,28.57,0,0,1,10,2010
D Brown,WI,2001,2002,1,2,0,9,1,10.0,20,50.0,0,0,0,10,2001
ML Cummins,WI,2014,2017,3,3,0,5,1,5.0,27,37.03,0,0,0,10,2014
DLS de Silva,SL,1979,1979,0,1,0,10,0,10.0,35,28.57,0,0,0,10,1979
JJ Esmeijer,NL,2002,2003,1,5,0,7,1,2.5,43,23.25,0,0,3,10,2002
B Geeves,AUS,2008,2009,1,2,1,10,2,0.0,11,90.9,0,0,0,10,2008
W Jaffer,INDIA,2006,2006,0,2,0,10,0,5.0,23,43.47,0,0,1,10,2006
Kabir Khan,PAK,1994,2000,6,5,0,5,4,10.0,25,40.0,0,0,0,10,1994
AV Kale,INDIA,2003,2003,0,1,0,10,0,10.0,22,45.45,0,0,0,10,2003
NJ MacRae,SCOT,2006,2006,0,2,0,8,0,5.0,36,27.77,0,0,0,10,2006
CA Marshall,CAN,1979,1979,0,2,0,8,0,5.0,41,24.39,0,0,0,10,1979
A Martin,WI,2011,2011,0,6,1,4,5,10.0,29,34.48,0,0,0,10,2011
BMW Patterson,SCOT,1999,1999,0,3,0,10,0,3.33,43,23.25,0,0,2,10,1999
Shabbir Ahmed,PAK,1999,2005,6,11,0,2,5,1.66,29,34.48,0,0,0,10,1999
Shariful Haque,BDESH,1998,1998,0,1,0,10,0,10.0,6,166.66,0,0,0,10,1998
RAJ Smith,SCOT,2016,2016,0,1,0,10,0,10.0,6,166.66,0,0,0,10,2016
TE Srinivasan,INDIA,1980,1981,1,2,0,6,0,5.0,35,28.57,0,0,0,10,1980
MP Stead,CAN,1979,1979,0,2,0,10,0,5.0,45,22.22,0,0,1,10,1979
GC Tonge,WI,2009,2009,0,4,0,5,2,5.0,16,62.5,0,0,0,10,2009
MDJ Walker,NZ,2003,2003,0,1,0,10,0,10.0,6,166.66,0,0,0,10,2003
WA Wisneski,NZ,2000,2000,0,2,0,6,1,10.0,17,58.82,0,0,0,10,2000
AK Zesers,AUS,1987,1987,0,2,1,8,2,0.0,14,71.42,0,0,0,10,1987
KK Ahmed,INDIA,2018,2019,1,3,0,5,1,4.5,17,52.94,0,0,0,9,2018
MJ Bennett,AUS,1984,1985,1,4,1,6,1,3.0,21,42.85,0,0,2,9,1984
SM Boland,AUS,2016,2016,0,4,0,4,1,3.0,22,40.9,0,0,1,9,2016
CE Bulfin,NZ,1999,1999,0,2,1,7,1,9.0,8,112.5,0,0,0,9,1999
SJ Cameron,SCOT,2018,2018,0,2,1,8,1,9.0,13,69.23,0,0,0,9,2018
SJ Chalmers,SCOT,2009,2009,0,1,1,9,1,0.0,14,64.28,0,0,0,9,2009
NA David,INDIA,1997,1997,0,2,1,8,2,0.0,10,90.0,0,0,0,9,1997
GN de Silva,SL,1983,1985,2,2,0,7,1,9.0,18,50.0,0,0,0,9,1983
GRA de Silva,SL,1975,1982,7,4,1,6,2,4.5,33,27.27,0,0,1,9,1975
DR Doshi,INDIA,1980,1982,2,5,1,5,2,3.0,20,45.0,0,0,2,9,1980
CJ Drum,NZ,1999,1999,0,2,1,7,2,0.0,22,40.9,0,0,0,9,1999
S Dube,INDIA,2019,2019,0,1,0,9,0,9.0,6,150.0,0,0,0,9,2019
Fahad Usman,UAE,2004,2004,0,2,0,9,0,4.5,18,50.0,0,0,1,9,2004
Faisal Athar,PAK,2003,2003,0,1,0,9,0,9.0,38,23.68,0,0,0,9,2003
SP Gauchan,NEPAL,2018,2018,0,1,1,9,1,0.0,44,20.45,0,0,0,9,2018
MJ Haslam,NZ,1992,1992,0,1,0,9,0,9.0,18,50.0,0,0,0,9,1992
AG Huckle,ZIM,1997,1999,2,8,1,5,4,2.25,16,56.25,0,0,3,9,1997
HR Johnson,USA,2004,2004,0,2,0,9,1,9.0,20,45.0,0,0,0,9,2004
Karim Janat,AFG,2017,2017,0,1,0,9,0,9.0,33,27.27,0,0,0,9,2017
JB Little,IRE,2019,2019,0,2,0,9,0,4.5,8,112.5,0,0,1,9,2019
DE Malcolm,ENG,1990,1994,4,5,0,4,2,3.0,11,81.81,0,0,1,9,1990
Mohammad Salim,BDESH,2003,2003,0,1,0,9,0,9.0,24,37.5,0,0,0,9,2003
PG Nana,EAf,1975,1975,0,3,1,8,2,9.0,45,20.0,0,0,1,9,1975
Naveen-ul-Haq,AFG,2016,2019,3,3,1,8,2,9.0,21,42.85,0,0,0,9,2016
Qadeer Ahmed,UAE,2015,2019,4,6,0,4,4,4.5,31,29.03,0,0,0,9,2015
LS Rajput,INDIA,1985,1987,2,4,0,8,1,3.0,31,29.03,0,0,2,9,1985
Rashid Zia,USA,2004,2004,0,2,0,8,0,4.5,57,15.78,0,0,0,9,2004
JA Snow,ENG,1971,1975,4,4,1,5,2,4.5,41,21.95,0,0,0,9,1971
OP Stone,ENG,2018,2018,0,1,1,9,1,0.0,7,128.57,0,0,0,9,2018
GP Sulzberger,NZ,2000,2000,0,2,1,6,1,9.0,15,60.0,0,0,0,9,2000
AJ Tudor,ENG,2002,2002,0,2,0,6,1,9.0,11,81.81,0,0,0,9,2002
VB van Jaarsveld,SA,2009,2009,0,2,0,5,0,4.5,15,60.0,0,0,0,9,2009
Zahid Hussain,CAN,2011,2011,0,2,1,7,1,9.0,31,29.03,0,0,0,9,2011
VR Aaron,INDIA,2011,2014,3,3,1,6,2,8.0,15,53.33,0,0,1,8,2011
Asif Iqbal,1) ,2015,2015,0,1,0,8,0,8.0,8,100.0,0,0,0,8,2015
RA Austin,WI,1978,1978,0,1,0,8,0,8.0,13,61.53,0,0,0,8,1978
BS Browne,WI,1994,1994,0,3,1,8,2,8.0,24,33.33,0,0,1,8,1994
CJ Dala,SA,2018,2018,0,2,0,5,1,8.0,6,133.33,0,0,0,8,2018
H Davids,SA,2013,2013,0,2,0,7,0,4.0,24,33.33,0,0,0,8,2013
PA Desai,CAN,2010,2014,4,8,1,3,5,2.66,55,14.54,0,0,2,8,2010
R Dhanraj,WI,1994,1995,1,2,0,8,1,8.0,32,25.0,0,0,0,8,1994
P Dharmani,INDIA,1996,1996,0,1,0,8,0,8.0,8,100.0,0,0,0,8,1996
TL Fernando,SL,1989,1989,0,1,0,8,0,8.0,6,133.33,0,0,0,8,1989
JC Gamage,SL,1995,1995,0,2,1,7,2,0.0,9,88.88,0,0,0,8,1995
Gholam Nousher,BDESH,1986,1990,4,3,0,4,2,8.0,16,50.0,0,0,0,8,1986
Hafizur Rahman,BDESH,1986,1986,0,1,0,8,0,8.0,24,33.33,0,0,0,8,1986
ND Hirwani,INDIA,1988,1992,4,7,0,4,3,2.0,29,27.58,0,0,2,8,1988
KH Butt,HKG,2008,2008,0,2,0,4,0,4.0,28,28.57,0,0,0,8,2008
ACI Lock,ZIM,1996,1996,0,3,0,5,2,8.0,20,40.0,0,0,0,8,1996
MA Lynch,ENG,1988,1988,0,3,0,6,0,2.66,32,25.0,0,0,1,8,1988
CS Martin,NZ,2001,2008,7,7,0,3,2,1.6,27,29.62,0,0,2,8,2001
EZ Matambanadzo,ZIM,1996,1997,1,5,1,5,3,4.0,33,24.24,0,0,1,8,1996
MG Neser,AUS,2018,2018,0,2,0,6,0,4.0,16,50.0,0,0,0,8,2018
A Nortje,SA,2019,2019,0,1,0,8,0,8.0,18,44.44,0,0,0,8,2019
PDRL Perera,SL,1999,2007,8,7,1,4,2,1.6,18,44.44,0,0,4,8,1999
Rahat Ali,PAK,2012,2016,4,7,1,6,4,2.66,37,21.62,0,0,2,8,2012
SS Raul,INDIA,1998,1998,0,2,0,8,0,4.0,14,57.14,0,0,1,8,1998
CA Reid,USA,2004,2004,0,2,0,6,0,4.0,17,47.05,0,0,0,8,2004
RL Sanghvi,INDIA,1998,1998,0,2,0,8,0,4.0,11,72.72,0,0,1,8,1998
VRV Singh,INDIA,2006,2006,0,1,0,8,0,8.0,13,61.53,0,0,0,8,2006
Sohail Butt,UAE,1994,1994,0,2,1,6,1,8.0,14,57.14,0,0,0,8,1994
DS Steele,ENG,1976,1976,0,1,0,8,0,8.0,12,66.66,0,0,0,8,1976
DM Vonhagt,SL,1985,1985,0,1,0,8,0,8.0,17,47.05,0,0,0,8,1985
HS Williams,SA,1999,2000,1,2,0,7,1,8.0,11,72.72,0,0,0,8,1999
NP Kenjige,USA,2019,2019,0,2,1,6,2,0.0,3,233.33,0,0,0,7,2019
RW Ali,KENYA,1996,1997,1,3,1,6,3,0.0,28,25.0,0,0,0,7,1996
J Cameron-Dow,IRE,2019,2019,0,1,1,7,1,0.0,10,70.0,0,0,0,7,2019
KG Duers,ZIM,1992,1992,0,2,0,5,1,7.0,20,35.0,0,0,0,7,1992
Fazl-e-Akbar,PAK,1998,2001,3,1,0,7,0,7.0,8,87.5,0,0,0,7,1998
WCA Ganegama,SL,2001,2006,5,2,0,7,0,3.5,9,77.77,0,0,1,7,2001
DM Gondaria,KENYA,2013,2013,0,2,0,6,0,3.5,45,15.55,0,0,0,7,2013
JOA Gordon,CAN,2012,2014,2,4,0,4,2,3.5,28,25.0,0,0,0,7,2012
VR Hogg,ZIM,1983,1983,0,1,1,7,1,0.0,19,36.84,0,0,0,7,1983
AG Hurst,AUS,1975,1979,4,4,1,3,4,0.0,19,36.84,0,0,0,7,1975
Izatullah Dawlatzai,AFG,2010,2015,5,3,1,6,1,3.5,27,25.92,0,0,1,7,2010
SD Jack,SA,1994,1995,1,2,0,6,0,3.5,8,87.5,0,0,0,7,1994
Jahangir Alam Talukdar,BDESH,1990,1990,0,1,1,7,1,0.0,16,43.75,0,0,0,7,1990
MKGCP Lakshitha,SL,2002,2003,1,2,0,4,1,7.0,12,58.33,0,0,0,7,2002
Liaqat Ali,PAK,1977,1978,1,1,0,7,0,7.0,31,22.58,0,0,0,7,1977
DSK Madushanka,SL,2018,2018,0,1,0,7,0,7.0,6,116.66,0,0,0,7,2018
GA Manou,AUS,2009,2009,0,1,0,7,0,7.0,6,116.66,0,0,0,7,2009
PL Mhambrey,INDIA,1996,1998,2,1,1,7,1,0.0,5,140.0,0,0,0,7,1996
EA Moseley,WI,1990,1991,1,6,1,2,2,1.75,15,46.66,0,0,2,7,1990
JK Moss,AUS,1979,1979,0,1,0,7,0,7.0,16,43.75,0,0,0,7,1979
Nazmul Islam,BDESH,2018,2018,0,1,0,7,0,7.0,13,53.84,0,0,0,7,2018
M Pushpakumara,SL,2009,2010,1,1,1,7,1,0.0,19,36.84,0,0,0,7,2009
RA Reifer,WI,2019,2019,0,1,0,7,0,7.0,12,58.33,0,0,0,7,2019
IDK Salisbury,ENG,1993,1994,1,2,0,5,1,7.0,12,58.33,0,0,0,7,1993
BM Scholtz,NAM,2019,2019,0,3,0,6,2,7.0,21,33.33,0,0,0,7,2019
K Shuttleworth,ENG,1971,1971,0,1,0,7,0,7.0,19,36.84,0,0,0,7,1971
EHSN Silva,UAE,2008,2008,0,1,0,7,0,7.0,13,53.84,0,0,0,7,2008
NA Statham,NL,2003,2009,6,3,0,7,0,2.33,50,14.0,0,0,2,7,2003
RJW Topley,ENG,2015,2016,1,5,0,6,4,7.0,40,17.5,0,0,0,7,2015
RF van Oosterom,NL,1996,2002,6,3,1,5,2,7.0,27,25.92,0,0,1,7,1996
SG Whittingham,SCOT,2017,2019,2,4,1,3,2,3.5,17,41.17,0,0,0,7,2017
T Yohannan,INDIA,2002,2002,0,2,1,5,2,0.0,11,63.63,0,0,0,7,2002
MKDI Amerasinghe,SL,2007,2008,1,4,1,5,4,0.0,9,66.66,0,0,0,6,2007
Bhupinder Singh snr,INDIA,1994,1994,0,1,0,6,0,6.0,13,46.15,0,0,0,6,1994
IW Callen,AUS,1978,1982,4,3,1,3,2,6.0,13,46.15,0,0,1,6,1978
GD Campbell,AUS,1989,1990,1,3,1,4,1,3.0,19,31.57,0,0,1,6,1989
U Chatterjee,INDIA,1995,1995,0,2,1,3,1,6.0,30,20.0,0,0,0,6,1995
MT Chinouya,ZIM,2013,2013,0,2,1,6,1,6.0,8,75.0,0,0,1,6,2013
DDP D'Silva,UAE,2019,2019,0,2,0,4,0,3.0,14,42.85,0,0,0,6,2019
WP Diepeveen,NL,2011,2011,0,1,0,6,0,6.0,7,85.71,0,0,0,6,2011
SO Dowrich,WI,2019,2019,0,1,0,6,0,6.0,8,75.0,0,0,0,6,2019
CE Eksteen,SA,1991,1994,3,2,1,6,2,0.0,25,24.0,0,0,0,6,1991
Fahim Muntasir,BDESH,2001,2002,1,3,0,5,1,3.0,17,35.29,0,0,1,6,2001
AP Grayson,ENG,2000,2001,1,2,0,6,0,3.0,13,46.15,0,0,1,6,2000
Harilal Shah,EAf,1975,1975,0,3,0,6,0,2.0,56,10.71,0,0,2,6,1975
Harvinder Singh,INDIA,1997,2001,4,5,1,3,1,1.5,19,31.57,0,0,1,6,1997
M Hendrick,ENG,1973,1981,8,10,1,2,5,1.2,22,27.27,0,0,3,6,1973
CC Henry,CAN,1979,1979,0,2,0,5,1,6.0,14,42.85,0,0,0,6,1979
P Krishnamurthy,INDIA,1976,1976,0,1,0,6,0,6.0,13,46.15,0,0,0,6,1976
MJ North,AUS,2009,2009,0,2,0,5,0,3.0,19,31.57,0,0,0,6,2009
LN Oluoch,KENYA,2011,2011,0,2,1,5,1,6.0,6,100.0,0,0,0,6,2011
AK Patel,INDIA,1984,1985,1,2,0,6,0,3.0,11,54.54,0,0,1,6,1984
DB Rundle,SA,1994,1994,0,2,0,6,0,3.0,11,54.54,0,0,1,6,1994
R Shepherd,WI,2019,2019,0,1,0,6,0,6.0,9,66.66,0,0,0,6,2019
Usman Shinwari,PAK,2017,2019,2,4,0,6,1,2.0,7,85.71,0,0,2,6,2017
RJ Webb,NZ,1983,1983,0,1,1,6,1,0.0,10,60.0,0,0,0,6,1983
DJ Worrall,AUS,2016,2016,0,1,1,6,1,0.0,4,150.0,0,0,0,6,2016
Aijaz Ali,USA,2004,2004,0,2,0,4,0,2.5,11,45.45,0,0,0,5,2004
RT Crandon,WI,2009,2009,0,1,0,5,0,5.0,9,55.55,0,0,0,5,2009
N Fernandes,UAE,2008,2008,0,1,0,5,0,5.0,13,38.46,0,0,0,5,2008
R Illingworth,ENG,1971,1973,2,2,0,4,0,2.5,18,27.77,0,0,0,5,1971
Jalal-ud-Din,PAK,1982,1983,1,2,0,5,0,2.5,5,100.0,0,0,1,5,1982
Jubair Hossain,BDESH,2014,2015,1,1,0,5,0,5.0,9,55.55,0,0,0,5,2014
Khalid Khan,HKG,2004,2004,0,2,0,3,0,2.5,8,62.5,0,0,0,5,2004
H McLeod,EAf,1975,1975,0,2,0,5,0,2.5,10,50.0,0,0,1,5,1975
Mansoor Amjad,PAK,2008,2008,0,1,0,5,0,5.0,10,50.0,0,0,0,5,2008
Maqsood Rana,PAK,1990,1990,0,1,0,5,0,5.0,13,38.46,0,0,0,5,1990
Najeeb Tarakai,AFG,2017,2017,0,1,0,5,0,5.0,18,27.77,0,0,0,5,2017
Naumanullah,PAK,2008,2008,0,1,0,5,0,5.0,4,125.0,0,0,0,5,2008
Neeyamur Rashid,BDESH,1999,1999,0,2,1,4,1,5.0,5,100.0,0,0,0,5,1999
DJ Pringle,EAf,1975,1975,0,2,0,3,0,2.5,15,33.33,0,0,0,5,1975
LN Rajbanshi,NEPAL,2019,2019,0,2,1,3,2,0.0,20,25.0,0,0,0,5,2019
D Ramnarine,WI,1997,2001,4,3,0,2,0,1.66,13,38.46,0,0,0,5,1997
Sajjad Akbar,PAK,1990,1990,0,1,0,5,0,5.0,9,55.55,0,0,0,5,1990
L Sivaramakrishnan,INDIA,1985,1987,2,4,1,2,2,2.5,24,20.83,0,0,0,5,1985
G Snyman,NAM,2003,2003,0,4,0,5,0,1.25,9,55.55,0,0,3,5,2003
Talha Jubair,BDESH,2002,2003,1,5,1,4,3,2.5,15,33.33,0,0,2,5,2002
Tanbir Hayder,BDESH,2016,2016,0,2,0,3,0,2.5,16,31.25,0,0,0,5,2016
DJ Terbrugge,SA,2000,2000,0,2,0,5,1,5.0,14,35.71,0,0,0,5,2000
RK Whelan,IRE,2007,2007,0,2,0,5,0,2.5,12,41.66,0,0,1,5,2007
Al-Amin Hossain,BDESH,2014,2015,1,7,1,2,5,2.0,20,20.0,0,0,2,4,2014
LS Bhandari,NEPAL,2018,2018,0,1,1,4,1,0.0,9,44.44,0,0,0,4,2018
MI Black,WI,2001,2001,0,2,0,4,0,2.0,14,28.57,0,0,1,4,2001
PS Eaglestone,IRE,2008,2008,0,1,0,4,0,4.0,3,133.33,0,0,0,4,2008
Fawad Ahmed,AUS,2013,2013,0,1,1,4,1,0.0,2,200.0,0,0,0,4,2013
PJ Franks,ENG,2000,2000,0,1,0,4,0,4.0,17,23.52,0,0,0,4,2000
PLS Gamage,SL,2014,2017,3,5,0,3,3,2.0,27,14.81,0,0,0,4,2014
D Ganesh,INDIA,1997,1997,0,1,0,4,0,4.0,8,50.0,0,0,0,4,1997
WT Gavera,PNG,2014,2017,3,1,1,4,1,0.0,6,66.66,0,0,0,4,2014
Z Groenewald,NAM,2019,2019,0,2,0,3,1,4.0,19,21.05,0,0,0,4,2019
Gursharan Singh,INDIA,1990,1990,0,1,0,4,0,4.0,10,40.0,0,0,0,4,1990
SD Heazlett,AUS,2017,2017,0,1,0,4,0,4.0,11,36.36,0,0,0,4,2017
Jahangir Alam,BDESH,1997,1999,2,3,0,3,0,1.33,22,18.18,0,0,1,4,1997
ML Lewis,AUS,2005,2006,1,1,1,4,1,0.0,4,100.0,0,0,0,4,2005
CH Lonsdale,BMUDA,2007,2007,0,1,0,4,0,4.0,28,14.28,0,0,0,4,2007
Mohammad Nazir,PAK,1980,1984,4,3,1,2,3,0.0,16,25.0,0,0,0,4,1980
GK Pandey,INDIA,1999,1999,0,2,1,4,1,4.0,11,36.36,0,0,1,4,1999
PI Pocock,ENG,1985,1985,0,1,0,4,0,4.0,9,44.44,0,0,0,4,1985
LN Roche,ZIM,2018,2018,0,2,0,4,0,2.0,10,40.0,0,0,1,4,2018
AM Salvi,INDIA,2003,2003,0,3,1,4,1,2.0,14,28.57,0,0,2,4,2003
Samiur Rahman,BDESH,1986,1986,0,2,0,4,0,2.0,7,57.14,0,0,1,4,1986
BB Seebaran,CAN,2003,2003,0,3,1,4,2,4.0,13,30.76,0,0,1,4,2003
Shahzad Khan,CAN,2007,2007,0,1,0,4,0,4.0,12,33.33,0,0,0,4,2007
B Stanlake,AUS,2017,2019,2,5,0,2,2,1.33,28,14.28,0,0,1,4,2017
RW Staple,USA,2004,2004,0,2,0,4,0,2.0,11,36.36,0,0,1,4,2004
PJR Steyn,SA,1995,1995,0,1,0,4,0,4.0,14,28.57,0,0,0,4,1995
R Sudhakar Rao,INDIA,1976,1976,0,1,0,4,0,4.0,14,28.57,0,0,0,4,1976
S Sumar,EAf,1975,1975,0,1,0,4,0,4.0,11,36.36,0,0,0,4,1975
Tanveer Ahmed,HKG,2016,2018,2,4,1,2,4,0.0,11,36.36,0,0,0,4,2016
VAB Tewarie,NL,2011,2011,0,1,0,4,0,4.0,22,18.18,0,0,0,4,2011
GS Trimble,AUS,1986,1986,0,2,0,4,1,4.0,5,80.0,0,0,0,4,1986
T van der Gugten,NL,2012,2013,1,2,0,2,0,2.0,6,66.66,0,0,0,4,2012
S Vesawkar,NEPAL,2018,2018,0,1,0,4,0,4.0,15,26.66,0,0,0,4,2018
SL Watkin,ENG,1994,1994,0,2,0,4,0,2.0,23,17.39,0,0,1,4,1994
UWMBCA Welegedara,SL,2009,2010,1,3,1,2,2,4.0,9,44.44,0,0,0,4,2009
RPAH Wickramaratne,SL,1993,1993,0,2,0,3,0,2.0,6,66.66,0,0,0,4,1993
P Wilson,AUS,1997,1998,1,5,0,2,2,1.33,13,30.76,0,0,2,4,1997
M Zondeki,SA,2002,2008,6,3,1,3,2,4.0,5,80.0,0,0,1,4,2002
SA Abbott,AUS,2014,2014,0,1,0,3,0,3.0,7,42.85,0,0,0,3,2014
Abdullah Mazari,AFG,2010,2010,0,1,0,3,0,3.0,16,18.75,0,0,0,3,2010
Ali Khan,USA,2019,2019,0,1,0,3,0,3.0,11,27.27,0,0,0,3,2019
CR Amini,PNG,2014,2014,0,1,1,3,1,0.0,3,100.0,0,0,0,3,2014
RA Bhatti,CAN,2011,2011,0,1,1,3,1,0.0,4,75.0,0,0,0,3,2011
JWHD Boteju,SL,1999,1999,0,2,0,2,1,3.0,11,27.27,0,0,0,3,1999
NR Dyer,SCOT,1999,1999,0,4,1,2,3,3.0,14,21.42,0,0,1,3,1999
D Gamage,SL,2003,2003,0,2,1,2,1,3.0,10,30.0,0,0,0,3,2003
LJ Hamilton,NZ,2005,2005,0,2,1,2,2,0.0,6,50.0,0,0,0,3,2005
RT Hart,NZ,1985,1985,0,1,0,3,0,3.0,29,10.34,0,0,0,3,1985
PD Heyn,SL,1975,1975,0,2,0,2,0,1.5,20,15.0,0,0,0,3,1975
Ijaz Ahmed jnr,PAK,1997,1997,0,1,1,3,1,0.0,2,150.0,0,0,0,3,1997
Junaid Siddique,UAE,2019,2019,0,2,0,2,1,3.0,10,30.0,0,0,0,3,2019
CK Kruger,HKG,2008,2008,0,2,0,3,0,1.5,20,15.0,0,0,1,3,2008
Mahbubur Rahman,BDESH,1999,1999,0,1,0,3,0,3.0,8,37.5,0,0,0,3,1999
Mazharul Haque,BDESH,2002,2002,0,1,0,3,0,3.0,18,16.66,0,0,0,3,2002
MC Mendis,SL,1995,1995,0,1,1,3,1,0.0,2,150.0,0,0,0,3,1995
CT Mumba,ZIM,2016,2017,1,2,1,2,1,3.0,7,42.85,0,0,0,3,2016
DJ Murray,NZ,1994,1994,0,1,0,3,0,3.0,17,17.64,0,0,0,3,1994
SV Nayak,INDIA,1981,1982,1,1,0,3,0,3.0,19,15.78,0,0,0,3,1981
IE O'Brien,NZ,2008,2009,1,2,1,3,2,0.0,11,27.27,0,0,0,3,2008
Pankaj Singh,INDIA,2010,2010,0,1,1,3,1,0.0,3,100.0,0,0,0,3,2010
JM Patel,CAN,1979,1979,0,3,0,2,0,1.0,23,13.04,0,0,1,3,1979
MJ Petrie,SCOT,2009,2009,0,2,0,3,0,1.5,18,16.66,0,0,1,3,2009
GD Porter,AUS,1979,1979,0,1,0,3,0,3.0,9,33.33,0,0,0,3,1979
U Ranchod,ZIM,1992,1993,1,1,1,3,1,0.0,6,50.0,0,0,0,3,1992
RE Redmond,NZ,1973,1973,0,1,0,3,0,3.0,11,27.27,0,0,0,3,1973
Sagar Pun,NEPAL,2018,2018,0,1,0,3,0,3.0,20,15.0,0,0,0,3,2018
A Shamshudeen,CAN,2007,2007,0,1,0,3,0,3.0,28,10.71,0,0,0,3,2007
CEL Stuart,WI,2001,2001,0,1,1,3,1,0.0,13,23.07,0,0,0,3,2001
Usman Mushtaq,UAE,2015,2015,0,1,0,3,0,3.0,7,42.85,0,0,0,3,2015
JN Valentine,CAN,1979,1979,0,2,1,3,2,0.0,17,17.64,0,0,0,3,1979
CJPG van Zyl,SA,1992,1992,0,2,1,3,1,3.0,11,27.27,0,0,1,3,1992
Yamin Ahmadzai,AFG,2015,2019,4,2,1,3,1,3.0,19,15.78,0,0,1,3,2015
Zahid Ahmed,PAK,1987,1987,0,2,1,3,1,3.0,13,23.07,0,0,1,3,1987
MZ Zahir,CAN,2009,2009,0,1,1,3,1,0.0,13,23.07,0,0,0,3,2009
Zakiullah Zaki,AFG,2012,2012,0,1,1,3,1,0.0,22,13.63,0,0,0,3,2012
JP Agnew,ENG,1985,1985,0,1,1,2,1,0.0,3,66.66,0,0,0,2,1985
Ahmed Shah,AFG,2009,2009,0,1,0,2,0,2.0,10,20.0,0,0,0,2,2009
Anisur Rahman,BDESH,1995,1998,3,2,0,2,0,1.0,11,18.18,0,0,1,2,1995
HWR Cartwright,AUS,2017,2017,0,2,0,1,0,1.0,23,8.69,0,0,0,2,2017
DJ Cullen,AUS,2006,2006,0,1,1,2,1,0.0,3,66.66,0,0,0,2,2006
BR Dorey,AUS,2006,2006,0,1,0,2,0,2.0,8,25.0,0,0,0,2,2006
WJ Edwards,AUS,1975,1975,0,1,0,2,0,2.0,14,14.28,0,0,0,2,1975
Elias Sunny,BDESH,2011,2012,1,4,1,1,2,1.0,11,18.18,0,0,1,2,2011
Fahad Nawaz,UAE,2019,2019,0,2,0,2,0,1.0,10,20.0,0,0,1,2,2019
PG Gillespie,IRE,2006,2007,1,4,0,2,0,0.5,14,14.28,0,0,3,2,2006
AAW Gunawardena,SL,1994,1994,0,1,0,2,0,2.0,10,20.0,0,0,0,2,1994
R Hekure,PNG,2019,2019,0,1,0,2,0,2.0,8,25.0,0,0,0,2,2019
BE Hendricks,SA,2019,2019,0,1,1,2,1,0.0,8,25.0,0,0,0,2,2019
KC Hodsoll,BMUDA,2007,2008,1,2,1,2,1,2.0,7,28.57,0,0,1,2,2007
Hussain Talat,PAK,2019,2019,0,1,0,2,0,2.0,14,14.28,0,0,0,2,2019
Ibrahim Zadran,AFG,2019,2019,0,1,0,2,0,2.0,9,22.22,0,0,0,2,2019
Irfan Sajid,UAE,2014,2014,0,1,0,2,0,2.0,5,40.0,0,0,0,2,2014
Junaid Zia,PAK,2003,2003,0,2,1,2,1,2.0,7,28.57,0,0,1,2,2003
K Kamyuka,CAN,2013,2013,0,1,0,2,0,2.0,2,100.0,0,0,0,2,2013
Kashif Raza,PAK,2001,2001,0,1,1,2,1,0.0,2,100.0,0,0,0,2,2001
RJ Kirtley,ENG,2001,2004,3,2,0,1,0,1.0,11,18.18,0,0,0,2,2001
Masood Iqbal,PAK,1984,1984,0,1,0,2,0,2.0,2,100.0,0,0,0,2,1984
SC Meaker,ENG,2011,2011,0,2,0,1,0,1.0,16,12.5,0,0,0,2,2011
DWO Morgan,BMUDA,2006,2006,0,2,0,1,0,1.0,11,18.18,0,0,0,2,2006
Morshed Ali Khan,BDESH,1998,1998,0,1,1,2,1,0.0,4,50.0,0,0,0,2,1998
SP Mukherjee,INDIA,1990,1991,1,1,1,2,1,0.0,2,100.0,0,0,0,2,1990
Nadeem Khan,PAK,1993,1995,2,1,0,2,0,2.0,3,66.66,0,0,0,2,1993
Nasir Javed,USA,2004,2004,0,1,1,2,1,0.0,19,10.52,0,0,0,2,2004
DR O'Sullivan,NZ,1974,1976,2,2,1,1,1,2.0,5,40.0,0,0,0,2,1974
R Pathan,CAN,2013,2013,0,1,0,2,0,2.0,9,22.22,0,0,0,2,2013
MR Pydanna,WI,1980,1983,3,1,1,2,1,0.0,3,66.66,0,0,0,2,1980
ACL Richards,WI,2007,2007,0,1,0,2,0,2.0,2,100.0,0,0,0,2,2007
Sameer Zia,UAE,2004,2004,0,1,1,2,1,0.0,20,10.0,0,0,0,2,2004
JNK Shannon,IRE,2013,2013,0,1,0,2,0,2.0,8,25.0,0,0,0,2,2013
GJ Thompson,IRE,2008,2008,0,2,0,2,0,1.0,21,9.52,0,0,1,2,2008
PIC Thompson,WI,1997,1997,0,1,0,2,0,2.0,7,28.57,0,0,0,2,1997
MS Tshabalala,SA,2007,2007,0,1,1,2,1,0.0,3,66.66,0,0,0,2,2007
AP Weerakkody,SL,1994,1994,0,1,0,2,0,2.0,4,50.0,0,0,0,2,1994
MD Wettimuny,SL,1983,1983,0,1,0,2,0,2.0,11,18.18,0,0,0,2,1983
DF Whatmore,AUS,1980,1980,0,1,0,2,0,2.0,6,33.33,0,0,0,2,1980
AGD Wickremasinghe,SL,1992,1993,1,1,0,2,0,2.0,10,20.0,0,0,0,2,1992
Abdul Rehman,UAE,2004,2004,0,1,0,1,0,1.0,13,7.69,0,0,0,1,2004
Abu Hider,BDESH,2018,2018,0,1,0,1,0,1.0,11,9.09,0,0,0,1,2018
Alawi Shukri,UAE,2008,2008,0,1,0,1,0,1.0,3,33.33,0,0,0,1,2008
Aminul Islam jnr,BDESH,1999,1999,0,1,1,1,1,0.0,0,0.0,0,0,0,1,1999
PJ Bakker,NL,1996,1996,0,1,1,1,1,0.0,4,25.0,0,0,0,1,1996
KMC Bandara,SL,2016,2016,0,1,1,1,1,0.0,3,33.33,0,0,0,1,2016
Bilal Khan,OMAN,2019,2019,0,2,1,1,1,1.0,7,14.28,0,0,1,1,2019
GA Cope,ENG,1977,1978,1,1,1,1,1,0.0,1,100.0,0,0,0,1,1977
MC Cowdrey,ENG,1971,1971,0,1,0,1,0,1.0,5,20.0,0,0,0,1,1971
CI Dunusinghe,SL,1995,1995,0,1,0,1,0,1.0,1,100.0,0,0,0,1,1995
MTG Elliott,AUS,1997,1997,0,1,0,1,0,1.0,6,16.66,0,0,0,1,1997
Fareed Ahmad,AFG,2014,2017,3,2,1,1,2,0.0,6,16.66,0,0,0,1,2014
RS Ghai,INDIA,1984,1986,2,1,0,1,0,1.0,3,33.33,0,0,0,1,1984
Gurdeep Singh,KENYA,2013,2013,0,1,0,1,0,1.0,23,4.34,0,0,0,1,2013
Iqbal Sikander,PAK,1992,1992,0,1,1,1,1,0.0,3,33.33,0,0,0,1,1992
SA Jayasinghe,SL,1979,1979,0,1,0,1,0,1.0,3,33.33,0,0,0,1,1979
SP Jones,ENG,2004,2005,1,1,0,1,0,1.0,2,50.0,0,0,0,1,2004
S Kaul,INDIA,2018,2018,0,2,0,1,0,0.5,3,33.33,0,0,1,1,2018
B Laughlin,AUS,2009,2009,0,1,1,1,1,0.0,9,11.11,0,0,0,1,2009
SCG MacGill,AUS,2000,2000,0,2,0,1,1,1.0,3,33.33,0,0,0,1,2000
Mahmood Hamid,PAK,1995,1995,0,1,0,1,0,1.0,6,16.66,0,0,0,1,1995
GJ McCarter,IRE,2014,2014,0,1,1,1,1,0.0,1,100.0,0,0,0,1,2014
JM Mennie,AUS,2016,2016,0,2,0,1,0,0.5,4,25.0,0,0,1,1,2016
Mohammad Kashif,NL,2006,2010,4,3,0,1,0,0.33,17,5.88,0,0,2,1,2006
Moniruzzaman,BDESH,2003,2003,0,2,0,1,0,0.5,20,5.0,0,0,1,1,2003
PV Mpitsang,SA,1999,1999,0,1,1,1,1,0.0,1,100.0,0,0,0,1,1999
M Mulla,CAN,2007,2007,0,1,0,1,0,1.0,11,9.09,0,0,0,1,2007
W Mwayenga,ZIM,2002,2004,2,2,0,1,0,0.5,11,9.09,0,0,1,1,2002
DP Nannes,AUS,2009,2009,0,1,0,1,0,1.0,2,50.0,0,0,0,1,2009
Nasim-ul-Ghani,PAK,1973,1973,0,1,0,1,0,1.0,8,12.5,0,0,0,1,1973
NV Ojha,INDIA,2010,2010,0,1,0,1,0,1.0,7,14.28,0,0,0,1,2010
G Onions,ENG,2009,2009,0,1,0,1,0,1.0,2,50.0,0,0,0,1,2009
KA Patel,KENYA,2006,2006,0,2,1,1,1,1.0,4,25.0,0,0,1,1,2006
Y Punja,UAE,2015,2015,0,1,0,1,0,1.0,6,16.66,0,0,0,1,2015
RR Ramdass,WI,2005,2005,0,1,0,1,0,1.0,9,11.11,0,0,0,1,2005
SJ Roberts,NZ,1990,1990,0,1,1,1,1,0.0,2,50.0,0,0,0,1,1990
LC Romero,USA,2004,2004,0,2,0,1,0,0.5,7,14.28,0,0,1,1,2004
R Sharma,INDIA,2011,2012,1,1,0,1,0,1.0,2,50.0,0,0,0,1,2011
KJ Silva,SL,1995,1995,0,1,1,1,1,0.0,1,100.0,0,0,0,1,1995
AM Stuart,AUS,1997,1997,0,1,0,1,0,1.0,7,14.28,0,0,0,1,1997
Subashis Roy,BDESH,2016,2016,0,1,1,1,1,0.0,9,11.11,0,0,0,1,2016
JP Taylor,ENG,1993,1993,0,1,0,1,0,1.0,8,12.5,0,0,0,1,1993
LB Taylor,ENG,1986,1986,0,1,1,1,1,0.0,6,16.66,0,0,0,1,1986
JG Thomas,ENG,1986,1987,1,3,1,1,2,1.0,7,14.28,0,0,1,1,1986
S Tyagi,INDIA,2009,2010,1,1,1,1,1,0.0,2,50.0,0,0,0,1,2009
KPJ Warnaweera,SL,1990,1993,3,3,1,1,3,0.0,11,9.09,0,0,0,1,1990
BA Westdijk,NL,2011,2011,0,3,1,1,1,0.5,6,16.66,0,0,2,1,2011
J Yadav,INDIA,2016,2016,0,1,1,1,1,0.0,1,100.0,0,0,0,1,2016
NS Yadav,INDIA,1986,1987,1,2,1,1,2,0.0,16,6.25,0,0,0,1,1986
B Yograj Singh,INDIA,1980,1981,1,4,0,1,2,0.5,12,8.33,0,0,1,1,1980
Yunus Badat,EAf,1975,1975,0,2,0,1,0,0.5,7,14.28,0,0,1,1,1975
Aman Ali,UAE,2008,2008,0,1,0,0,0,0.0,2,0.0,0,0,1,0,2008
J Angel,AUS,1994,1995,1,1,0,0,0,0.0,3,0.0,0,0,1,0,1994
Anwar Hossain Monir,BDESH,2002,2002,0,1,1,0,1,0.0,8,0.0,0,0,0,0,2002
S Baksh,CAN,1979,1979,0,1,0,0,0,0.0,6,0.0,0,0,1,0,1979
MRCN Bandaratilleke,SL,1998,1998,0,1,0,0,0,0.0,2,0.0,0,0,1,0,1998
JE Benjamin,ENG,1994,1995,1,1,0,0,0,0.0,6,0.0,0,0,1,0,1994
A Bhandari,INDIA,2000,2004,4,1,1,0,1,0.0,0,0.0,0,0,0,0,2000
DL Blake,USA,2004,2004,0,1,0,0,0,0.0,2,0.0,0,0,1,0,2004
BP Bracewell,NZ,1978,1978,0,1,1,0,1,0.0,4,0.0,0,0,0,0,1978
RG Callender,CAN,1979,1979,0,2,0,0,0,0.0,5,0.0,0,0,2,0,1979
NM Carter,SCOT,2013,2013,0,1,0,0,0,0.0,6,0.0,0,0,1,0,2013
K Christie,HKG,2016,2016,0,1,0,0,0,0.0,3,0.0,0,0,1,0,2016
Fahad Alhashmi,UAE,2008,2015,7,3,0,0,0,0.0,7,0.0,0,0,3,0,2008
Fazle Mahmud,BDESH,2018,2018,0,2,0,0,0,0.0,9,0.0,0,0,2,0,2018
R Flannigan,SCOT,2010,2010,0,1,0,0,0,0.0,2,0.0,0,0,1,0,2010
LR Gibbs,WI,1973,1975,2,1,1,0,1,0.0,0,0.0,0,0,0,0,1973
N Gifford,ENG,1985,1985,0,1,0,0,0,0.0,8,0.0,0,0,1,0,1985
VD Grandia,NL,2002,2002,0,1,0,0,0,0.0,5,0.0,0,0,1,0,2002
Hamza Tahir,SCOT,2019,2019,0,2,0,0,0,0.0,2,0.0,0,0,2,0,2019
RG Hart,NZ,2002,2002,0,1,0,0,0,0.0,9,0.0,0,0,1,0,2002
Harunur Rashid,BDESH,1988,1988,0,2,0,0,0,0.0,17,0.0,0,0,2,0,1988
SM Harwood,AUS,2009,2009,0,1,0,0,0,0.0,4,0.0,0,0,1,0,2009
Ishtiaq Muhammad,HKG,2016,2016,0,1,1,0,1,0.0,0,0.0,0,0,0,0,2016
Kaleemullah,OMAN,2019,2019,0,1,0,0,0,0.0,2,0.0,0,0,1,0,2019
PHT Kaushal,SL,2015,2015,0,1,0,0,0,0.0,1,0.0,0,0,1,0,2015
GJP Kruger,SA,2006,2006,0,2,1,0,1,0.0,10,0.0,0,0,1,0,2006
AGR Loudon,ENG,2006,2006,0,1,0,0,0,0.0,0,0.0,0,0,1,0,2006
OC McCoy,WI,2018,2018,0,1,1,0,1,0.0,1,0.0,0,0,0,0,2018
AW Mathieson,NZ,2015,2015,0,1,1,0,1,0.0,0,0.0,0,0,0,0,2015
KP Meiyappan,UAE,2019,2019,0,1,0,0,0,0.0,1,0.0,0,0,1,0,2019
JP Millmow,NZ,1990,1990,0,1,1,0,1,0.0,3,0.0,0,0,0,0,1990
Mohammad Khalil,PAK,2005,2005,0,1,1,0,1,0.0,0,0.0,0,0,0,0,2005
Mohammad Talha,PAK,2014,2014,0,1,0,0,0,0.0,1,0.0,0,0,1,0,2014
D Mohammed,WI,2006,2008,2,1,1,0,1,0.0,2,0.0,0,0,0,0,2006
Naeem Ahmed,PAK,1978,1978,0,1,1,0,1,0.0,8,0.0,0,0,0,0,1978
Najaf Shah,PAK,2007,2007,0,1,0,0,0,0.0,2,0.0,0,0,1,0,2007
Naseer Malik,PAK,1975,1975,0,1,1,0,1,0.0,13,0.0,0,0,0,0,1975
Nasir Hameed,HKG,2004,2004,0,1,0,0,0,0.0,1,0.0,0,0,1,0,2004
AM Nayar,INDIA,2009,2009,0,1,1,0,1,0.0,7,0.0,0,0,0,0,2009
N Ncube,ZIM,2011,2011,0,1,1,0,1,0.0,0,0.0,0,0,0,0,2011
A Neill,SCOT,2019,2019,0,1,1,0,1,0.0,3,0.0,0,0,0,0,2019
MB Owens,NZ,1992,1992,0,1,0,0,0,0.0,3,0.0,0,0,1,0,1992
NM Parker,NZ,1976,1976,0,1,0,0,0,0.0,3,0.0,0,0,1,0,1976
NT Pascal,WI,2009,2009,0,1,0,0,0,0.0,1,0.0,0,0,1,0,2009
N Phillip,WI,1978,1978,0,1,0,0,0,0.0,5,0.0,0,0,1,0,1978
AG Puttick,SA,2005,2005,0,1,0,0,0,0.0,5,0.0,0,0,1,0,2005
NV Radford,ENG,1988,1988,0,3,1,0,2,0.0,7,0.0,0,0,1,0,1988
Rafiqul Islam,BDESH,2002,2002,0,1,0,0,0,0.0,5,0.0,0,0,1,0,2002
CAK Rajitha,SL,2018,2019,1,3,1,0,2,0.0,10,0.0,0,0,1,0,2018
DR Ramsammy,CAN,2012,2012,0,1,0,0,0,0.0,3,0.0,0,0,1,0,2012
N Ranatunga,SL,1993,1993,0,1,0,0,0,0.0,3,0.0,0,0,1,0,1993
Raza Hasan,PAK,2014,2014,0,1,0,0,0,0.0,2,0.0,0,0,1,0,2014
Rizwan Latif,UAE,2004,2004,0,1,0,0,0,0.0,2,0.0,0,0,1,0,2004
Robiul Islam,BDESH,2013,2013,0,1,1,0,1,0.0,1,0.0,0,0,0,0,2013
Saqib Zulfiqar,NL,2019,2019,0,1,0,0,0,0.0,4,0.0,0,0,1,0,2019
Shadab Kabir,PAK,1996,1996,0,3,0,0,0,0.0,5,0.0,0,0,3,0,1996
Shakeel Khan,PAK,1987,1987,0,1,0,0,0,0.0,4,0.0,0,0,1,0,1987
T Shamsi,SA,2016,2019,3,3,1,0,2,0.0,2,0.0,0,0,1,0,2016
Simandeep Singh,HKG,2018,2018,0,1,0,0,0,0.0,7,0.0,0,0,1,0,2018
GS Sobers,WI,1973,1973,0,1,0,0,0,0.0,6,0.0,0,0,1,0,1973
Tanvir Mehdi,PAK,1992,1992,0,1,0,0,0,0.0,5,0.0,0,0,1,0,1992
M Venkataramana,INDIA,1988,1988,0,1,1,0,1,0.0,0,0.0,0,0,0,0,1988
R Walters,NAM,2003,2003,0,2,0,0,0,0.0,5,0.0,0,0,2,0,2003
CM Willoughby,SA,2000,2003,3,2,0,0,0,0.0,4,0.0,0,0,2,0,2000
Zakir Hossain,BDESH,1998,1998,0,1,0,0,0,0.0,1,0.0,0,0,1,0,1998
Aamer Hameed,PAK,1977,1978,1,0,0,0,0,0.0,0,0.0,0,0,0,0,1977
Abdur Rauf,PAK,2008,2008,0,0,0,0,0,0.0,0,0.0,0,0,0,0,2008
Abu Jayed,BDESH,2019,2019,0,0,0,0,0,0.0,0,0.0,0,0,0,0,2019
FS Ahangama,SL,1985,1985,0,0,0,0,0,0.0,0,0.0,0,0,0,0,1985
GW Aldridge,NZ,2011,2011,0,0,0,0,0,0.0,0,0.0,0,0,0,0,2011
ZS Ansari,ENG,2015,2015,0,0,0,0,0,0.0,0,0.0,0,0,0,0,2015
Ariful Haque,BDESH,2018,2018,0,0,0,0,0,0.0,0,0.0,0,0,0,0,2018
Ashfaq Ahmed,PAK,1994,1994,0,0,0,0,0,0.0,0,0.0,0,0,0,0,1994
MD Bailey,NZ,1998,1998,0,0,0,0,0,0.0,0,0.0,0,0,0,0,1998
GR Beard,AUS,1981,1981,0,0,0,0,0,0.0,0,0.0,0,0,0,0,1981
